(felles) digital læringsplattform	searvvušlaš bargoneavvut, searválas bargoneavvut

ABO gruppering, blodtypesystem	ABO-varrajoavkkut

Abelsborg	Áppošborri

Additiv	additiiva

Algerier	algerialaš

Alteidet	Duikkášmuotki

Altesula	Álpesuolu

Andorraner	andorralaš, andorrálaš

Andørja	Áttir

Arnøy	Árdni - Stuorra Árdni

Berlevåg	Bearalváhki

Biedjovággi	Biedjovággi

Billefjordelv	Billájohka

Bjørnevatn	Guovžajávri

Bjørnevatnet	Guvžajávri

Braselv	Guolleveadji

Brennelva	Lavttejohka

CDI-boks	cahkkehanboksa

Divielva	Dieváideatnu

Dyfjord	Dáigevuotna

EDB-avdeling	dihtorossodat

EDB-konsulent	dihtorneavvu

EKG	elektrokardiográmma, EKG

HDL-kolesterol	HDL-kolesterola

Handelskompaniet	Gávpesearvi

Høyesterett	Alimusriekti

Kjølmangen	Čoalbmi

LDL-kolesterol	LDL-kolesterola

Lille Tamsøya	Ávačuohttu

Lov om pliktmessig avhold	čielggusvuođa geatnegahtti láhka

Mehamn	Donjevuotna

Meskelv	Álddanjárga

Meskelva	Álddajohka

Møtet er satt.	Čoahkkin lea álggahuvvon.

Nesseby	Unjárga

Nuvsvåg	Cuokcavuotna

Porsa	Borsi

Reindriftsloven	Boazodoalloláhka

Sosialdepartementet	Sosiáladepartemeanta

Sosialistisk Vensterparti	Sosialistalaš Gurutbellodat

Stille - møte pågår.	Jaskat. čoahkkin

Subtraktiv	subtraktiiva

Tiden er ute.	Áigi lea dievvan.

Til dagsorden.	Čoahkkinortnegii.

Trålerkomiteen	Áhpenuohtástanlávdegoddi

Vestre Jakobselv	Ánnejohka

Vis stemmetegn.	Čájehehket jienastanmearkka.

absolutt flertall	dievas eanetlohku

abstinenssymptom	eaidanmearkkat

acetylen	acetylena

acetylsalisylsyre	acetylsalisylsivra, asetosalisylasivra

adaptasjon	adaptašuvdna

adapter	adapter

addend	lasidahtti

adressat	vuostáváldi

adresselinje	čujuhuslinnjá

adresseringsmaskin	adresserenmašiidna

adresseringspapir	adresserenbábir

aduserjern	aduserruovdi

advokatbevilling	advokáhttalohpi

afghaner	afganlaš, afghanistanlaš

agering	láhtten

agnsil	seaktesivla

akkar	áhkkár

akkumulator	akkumuláhtor

akkumulering	čoggojupmi

akkumulert avskrivning	čoagganan vuolideapmi

akselavstand	áksilgaska

akselerasjon	leaktolassáneapmi

akselerasjonsfelt	lehttohat

aksellast	áksildeaddu

aksellastgrense	fievrru stuorámus lobálaš áksildeaddu

akseltapp	áksilculci

akseptabel	dohkálaš

aksiallager	aksiálláger

aktiv rolle	árjjálaš

aktivere	árvun čállit

aktivitetsområde	doaibmaguovlu

aktomslag	áššebábirmáhppa

aktor	áktor

akvakulturanlegg	čáhcedikšunrusttet

akvatisk organisme	čáhceealán

albaner	albánialaš, albanialaš

alders tids bruk	dološ áiggi rájes geavaheapmi

alfabetisk hjelperegister	alfabehtalaš veahkkeregisttar

alfabetisk oppstilling	alfabehtalaš ortnet, alfabehtalaš bordin

alfanumeriske data	alfanummaraston dieđut

alke	ruohkki

alkekonge	áhpecizaš

alkoholforbrenning	alkoholaboaldu

alkoholfri	alkoholkeahttá

allmennbegrep	oktasašdoaba

allmenne hensyn	almmolaš beroštupmi

allmennfarlig	oppalaččat várálaš

allmennprosess	dábálaš proseassa

alltrafikkveg	seahkálajohtolatluodda

alluvial	doidon

allé	alléa
allé	muorragudji

almenningsberettiget	almennetvuoigaduvvon

almenningslignende	almennetsullasaš

alminnelig ferdsel	dábálaš johtáleapmi

alminnelig flertall	dábálaš eanetlohku

alminnelig meddommer	dábálaš mielduopmár

alminnelig straff	dábálaš ráŋggáštus

altan	altána

alternativ kostnad	molssoeavttolaš gollu

altomfattende	buotdivnnat

ambolt	stáđđi

ambulerende spesialist	johtti vásedindoavttir

amtmannsinstruks	ámtamánnigohččun

amtsfullmektig	ámtadoaimmaheaddji

analysedata	guorahallandieđut

analytisk trafikkprognosemetode	analyhtalaš johtolateinnostanvuohki

andre, grøntområder	eará, ruonas eatnamat

anedoktisk	leaikastalli

anekdote	cukca

anførelsesskrift	čuoččuhusčálus

anførsel	čuoččuhus

angi	čilget

angis	almmuhuvvot

angivelse	mearus
angivelse	čilgen

angolaner	angolalaš

angrepne	guoddaluvvon

angrepsspiller, spiss	njunuščiekči

ankeadgang	guoddalanlohpi

ankebegjæring	guoddalanbivdda

ankedomstol	guoddalanduopmostuollu

ankeerklæring	guoddalančálus

ankeforhandling	guoddalandiggi

ankefrist	guoddalanáigi

ankegjenstand	guoddalanfáddá

ankegrunn	guoddalanágga

ankekompetanse	guoddalanváldi

ankende	guoddaleaddji

ankeprøving	guoddalandárkkástus

ankerett	guoddalanvuoigatvuohta

ankerplass	áŋkorastinsadji

anketilsvar	guoddalanvástádus

ankeutvalg	guoddaluslávdegoddi

anklageprinsippet	sivahanprinsihppa

anlegg for avløpsvann	durdečáhcerusttet, duolvačáhcerusttet

anlegge	čuoččaldahttit

anlegge sak	čuoččaldahttit ášši

anleggsmaskin	ráhkadusmašiidna

anleggsregister	rusttetregisttar

anløping	devkkodahttin

anneksjonsskilt	eanaváldingalba

annen bygningsart	eará viessošládja

annen bygningslokalitet	iežá vistesadji

annen enkeltminneart	eará ovttaskasmuitošládja

annen fare	eará várra

annen marin lokalitet	iežá mearrabáiki

annen type lokalitet	iežálágán báiki

annet arkeologisk enkeltminne	eará arkeologalaš ovttaskasmuitu

annuitetsbegrep	ánnuitehtadoaba

anoreksi	anoreksiija

anse for å være dyr	divrrašit

anstalt	dikšoásahus

anstrengelseslekkasje	ražastaninkotineansa

ansvarsforsikring	ovddasvástádusa dáhkádus

antas	navdojuvvot

antennelse	buollán

antidepressiva	antidepressanta

antiguaner	antigualaš, antiguabarbudalaš

anvende en lov	geavahit lága

anvendes	geavahuvvot

anvendt	geavahuvvon

applausarrangement	speažžunsajádat

arbeiderbolig	bargiidásodat

arbeidersamfunn	bargoservodat

arbeidsbrakke	bargiidbráhkka

arbeidseffektivitet	bargoárjja

arbeidsmonn	bargomunni

arbeidsslag	bargodákta

arbeidsudyktighet	bargonávccahisvuohta

arealbegrensende	eananáddjejuvvon

arealdisponeringsforbud	eananháldengielddus

arealdisponeringstiltak	eananháldendoaibma

argentiner	argentinalaš, argentiinnálaš

arkaisk	dološáigásaš

arketype	árkatiipa

arkivalier	arkiivadokumenttat

arkivboks	arkiivaboksa

arkmater	árkacokkan

arksamler	árkadustton

arktisk jordbruk	davvieanandoallu

armener	armenialaš

armstøtte	doallansoadji

arran	árran

arrest	areasta
arrest	duogušteapmi

arrestert	duoguštuvvon

arrestgjenstand	duoguštusáhta

arrestgrunn	duoguštanágga

arresthaver	duoguštusgáibideaddji

arrestkrav	duoguštangáibádus

art_navn	art_navn	+?

artsbestemt vare	šládjagálvu

arveanlegg	árbeláhttu

arveforhold	árbegaskavuohta

arvelodd	árbeoassi

aserbajdsjaner	azerbaižanlaš

asfaltbetong	asfáltabetonga

asfaltblanding	asfálta seaguhus

asfaltemulsjon	asfáltaemulšuvdna

asfaltert veg	asfáltaluodda

asfaltinnhold	asfáltasisdoallu

asfaltkanal	asfáltarenne

asfaltkokeri	asfáltabáhti

asfaltmastriks	asfáltamastriksa

asfaltrik	asfáltái

asfaltverk	asfáltahat

assimilert	seahkánan

assosiativ begrepsrelasjon	assosiatiiva doabagaskavuohta

asymmetrisk lys	ásymmehtralaš čuovga

atelier	ateliera

atferdsregel	meannonjuolggadus

atferdsregulering	meannomudden

atskillende kjennetegn	earuheaddji dovdomearka

atypisk anoreksi	atypihkalaš anoreksiija, atiippalaš anoreksiija

atypisk bulimi	atiippalaš bulimiija, atypihkalaš bulimiija

atypisk spiseforstyrrelse	atypihkalaš borranváddu, atiippalaš borranváddu

augebolt	čalbmeboaltu

australier	australialaš, austrálialaš

autoritativ	válddálaš

autovern	luoddagilgga suodjeáidi

avbestillingsseddel	diŋgonmáhcahanlihppu

avbrutt trafikkstrøm	boatkka johtolatrávdnji

avbryterkontakt	dollaveažir

avdragsvis	osiid mielde

avgassanlegg	bázahasrusttet

avgiftsfri trafikk	nuvttá johtolat

avgiftsparkering	divatorosteapmi

avgiftssone	divatguovlu

avgjørelsesgrunn	mearridanvuođuštus

avgjørelsesgrunnlag	mearridanvuođđu

avgjørelsesmyndighet	mearridanváldi

avgrenset	ráddjejuvvon

avhente	vieččahallat

avhjelpe	geahpedit

avholde møte	čoahkkimastit

avholdelse	doallan

avhøre	gažadit

avhørsmøte	gažadančoahkkin

avhørte	gažaduvvon

avisholder	aviisadoalan

avisoleringstang	garahanbasttat

avkall	luohpan

avkastluft	lossaáibmu

avkjøringsfelt	eretvuodjinjuohku

avkjøringsskilt	eretvuodjingalba

avkjørselstillatelse	eretvuojáhatlohpi

avkrefte	hilgut

avkreftelse	hilgun

avkreftelse av mistanke	várohusa duššindahkan

avkryssingsoppgave	ceahkkunbargobihttá

avledet term	suorggádus, suorggiduvvon tearbma

avleiret	geardásaš

avlufting	áibmosirren

avlytte	guldalit

avlytting	guldaleapmi

avløpsanlegg	duolvačáhcerusttet

avløpspumpe	rufebumpe

avløpsrør	duolvačáhcebohcci
avløpsrør	ruferevre

avpasse	muddet

avpasse farten	heivehit leahtu

avsettes	cieggat

avsi dom	cealkit duomu

avsigelse	cealkin

avskaffelse	loahpaheapmi

avskjermet	suodjaluvvon

avskjerming	suodjaleapmi

avskjæring	suohpáhus

avsone	gednet

avspark	álggaheapmi

avstand til forankjørende	gaska ovddabealvuoddjái

avstand til gangfelt	gaska rastamannan vázzinluddii

avstandsoppfattelse	gaskaipmárdus

avstandsskilt	gaska ruovdemáđiirastehahkii

avstikking	čuggen

avtrekk	áibmogeassin, áibmonjiellu
avtrekk	áibmonjiellu

avveining	vihkkedeapmi

avvente	vuordit

avvike	spiehkastit

avvikende	spiehkasteaddji

badebasseng	vuojadanálddis

badematte	gummirátnu

bahamaner	bahamasuolohas

bahrainer	bahrainlaš

bakaksel	maŋŋeáksil

bakdokke	geahčedoalan

bakerste båtspante	maŋŋerággu

bakke utenfor marbakken	fávlebáhkka

bakkskive	oalulgiddehat

baklengs renteregning	maŋosguvlui reantorehkenastin

bakslag	galkan

balansekolonne	dásádatčuolda

balansekonto	dásádatkontu

balansekvantumsprinsipp	dássádathivvodatprinsihppa

balanseoppstilling	dásádatlogahallan

balansere hjul	dássádallat juvlla

ballastrøys	deattageađgelátna

balustrade	ravdarinda, luoddaáidi

bananplugg	bananbunci

bandmål	mihtidanbáddi

bangladesher	bangladeshlaš

bankinnskudd	sisabidju

banner	banner

barbader	barbadoslaš

barbiturat	barbituráhtta

barne- og ungdomslitteratur	mánáid- ja nuoraidgirjjálašvuohta

barnehageloven	mánáidgárdeláhka

barneloven	mánáidláhka

barnesete	máná biilastuollu

barnevernloven	mánáidsuodjalusláhka

barneverntjeneste	mánáidgáhttenbálvalus

barre	bárra

basert	vuođđuduvvon

bautastein	bázzi

bautasteinslokalitet	bázzebáiki

be innstendig	ávžžuhit sakka

be om unnskyldning	átnut ándagassii

bearbeidelse	heivehus

bebreide	cuiggodit

bebude	ilbmadit

bebygd areal	huksejuvvon areála

bedriftshelsetjenesten	fidnodearvvašvuođabálvalus

bedriftsmessige avskrivning	fitnodatlaš vuolidahttin

bedriftsøkonomisk	fitnodatekonomalaš

befaring	geahčadeapmi

befordring	fievrrádus

befordringsmiddel	fievru

beføyelse	ráđđejupmi

begerlav	bohccejeagil

begjærende instans	gáibidaninstánsa

begjæring	gáibádus

begrepsanalyse	doabaanalysa

begrepsapparat	doabaáddejupmi

begrepsdiagram	doabadiagrámma, doabagovus

begrepsfelt	doabasuorgi, doabagieddi

begrepsharmonisering	doabaharmoniseren

begrepsomfang, ekstensjon	doabaviidodat, ekstenšuvdna

begrepssystem	doabavuogádat

begrunnet	sudjadit

begunstigelse	oidu

begynne presis	álgit juste diibmomearis

begå	dahkat

behandling i henhold til vegloven	gieđahallan luoddalága mielde

behandlingsrutine	meannudandagaldupmi

behandlingsøyemed	dikšunulbmil

beholder for væske	njalbelihtti

beholdningsendring	rádjonuppástus

beholdningsvurdering	rádjoárvvoštallan

behosprøving	dárboiskkadus

beinbrudd	doddjon dákti

beingjømme	dáktečiehká

beitekonsulent	guohtunoaivadeaddji

beitekrenking	guohtonrihkkun

beiterettshaver	guohtonvuoigatvuođalaš

bekreftende	duođašteaddji

belagt vegskulder	devdon luoddabealla

belastende	deaddi

belastet med for mye arbeid	heavganit

belegg	gokčangeardi

belgier	belgialaš

belizer	belizelaš

bemanne	veagaiduhttit

bemanning	bargoveahka
bemanning	bálvágoddi

bemektigelse	háldui váldin

bemyndige	fápmudit

bemyndiget	fápmuduvvon

bend	sodju
bend	moalki

beneficerende	ámmátlaš

benet som danner feste for gjellene	ákkildákti

beniner	beninlaš

bensinmotor	bensinmohtor

bensintilførsel	bensiidnaboahtu

benåde	árpmihit

benådning	árpmiheapmi

beramme	beaivádit
beramme	áiggi mearridit

berammelse	beaivádeapmi

beregnet skatt	meroštallon vearru

beregnet trafikkmengde pr. time	meroštallon johtolathivvodat diimus

beregningsregler	meroštallannjuolggadusat

berettiget	vuoigadahtton
berettiget	vuoigaduvvon
berettiget	sujalaš

bergfrihet	bákteluđolašvuohta

berggrunnsdannelse	báktevuođđohámáiduvvan

berghald	geađgeduvdni

bergmessig	báktelaš

bergregale	bákteregála

bergverksfaglig	báktefágalaš

beruset	gárrenoaivvis

berørt	guoskevaš

besiktige	geahčadit dárkilit

besitte	háldet

besittelsesforhold	háldodilli

besittelsesrett	háldovuoigatvuohta

besittelsestakelse	hálddus váldin

besitter	háldejaš

besitter av grunn	eanaháldejaš

beskaffenhet	lágášvuohta

beskatningsprivilegie	vearuhisovdamunni

beskikke	nammadit

beskikkelse	nammadeapmi

beslag	duoguštus

bestikkelse	duolgu

bestiller	dagaheaddji

bestride	eahpidit
bestride	vásttostit

bestyrelse	hovden

besuttenhet	govttolaš birgejupmi

besvogret	láhčamat

besværing	váidalus

besøksforbud	lahkonangielddus

besørge	doaimmahit
besørge	fuolahit

betegnelse, benevnelse, benevning	namahus

betinget	evttolaš

betinget dom	evttolaš duopmu

betinget fengsel	evttolaš giddagas

betinget forelegg	evttolaš sáhkkocealkkus

betonglokk	betoŋgalohkki

betongveg	betoŋgaluodda

betro	dovddahit luohttámušain

betydelig flertall	mearkka šahtti eanetlohku

betydningsløs	mearkkaškeahttá
betydningsløs	mearkkašmeahttun

bevegelig bru	loktenšaldi

bevirke	váikkuhit

bevisanke	duođaštusguoddaleapmi

bevisbyrde	duođaštannoađđi

bevisframlegging	duođaštusovdanbuktin

bevisfritak	duođaštusčovdojupmi

bevisførsel	duođaštallan

beviskraft	duođaštusvuoibmi

bevislig	duođaštuslaš

bevismessig	duođaštuslaš

bevismiddel	duođaštusgaskaoapmi

bevisoppgave	duođaštusdieđáhus

bevisopptaksrett	rádjagastindiggi

bevisplikt	duođaštusgeatni

bevisregel	duođaštusregel

bevisspørsmål	duođaštusgažaldat

bevistilbud	duođaštusfálaldat

bevistilgang	duođaštusbeassamuš

bevisumiddelbarhetsprinsipp	njuolggoduođaštallanprinsihppa

bevisundersøkelse	duođaštusiskan

bhutaner	bhutanlaš

bibliotekbygning	girjerájusvisti

bidragsmetoden	buvttusvuohki

bidragsyter	doarjjafálli

biegg	oalgeávju

bifallsrop	doarjjačuorvun

bikkjenever	beatnatjeagil

bilag	girjemielddus
bilag	čuovus

bilansvarsloven	biilaovddasvástádusláhka

bildeavhør	govvagažadeapmi

bildrift	biiladoallan

bilfritt område	biillahis guovlu

bilføreransvar	biilavuoddji ovddasvástádus

bilholdsprognose	biilahivvodaga einnostat

bilisme	bilisma

billighetserstatning	ánsobuhtadus

bilpark	biilahivvodat

bilramme	biilarámma

biltetthet	biilaeatnatvuohta

bindemiddel	čatnanávnnas

bindende	čadni

bindende avtale	geatnegahtti soahpamuš

bindingsverk	huksenriggi

biografisk litteraturforskning	biográfalaš girjjálašvuođadutkan

biotop	biotopa

birkarl	birkelaš

bisitter	čuovvu

bisol	áitalas

bissauguineaner	guineabissaulaš

bistandsadvokat	doarjjaadvokáhtta

bistasjon	bivdovisttáš

bistå	veahkehit

bitte garn	gođđit fierpmi

bjørkefink	vintán

bjørnegrav	guovžžahávdi

bladfjær	duolbadávgi

bladsøker	goavkedulka

blande sammen	mastadit

blandet oppstilling	seahkálas ortnet, seahkálas bordin

blandingsforhold	seaguhusgorri

blandingstekstil	seaguhustekstiila

blankettstraffebud	blankeahttaráŋggáštus

blankofullmakt	rabasfápmudus

blaut fisk	šlieddaguolli

blending	čalmmehuvvat čuovgga dihte

blestertuft	vuossobádjesadji

bli arbeidsløs	bargguhuvvat

bli dyrere	divrut

bli erklært for skyldig	áššáskuvvat

bli forgjeldet	buddáduvvat

bli innløst	lotnašuvvat

bli jevnere	dásásmit

bli konfrontert med	deaividit

bli kraftløs	álmmehuvvat

bli mindre etterspurt	jođuhuvvat

bli nedsnedd	addjot

bli rimbelagt	bihcut

bli ruinert	nohkkot

bli slitt	suovganit

bli snøvær	almmáskit

bli stødig	stáđásmit

bli større	stuorásmit

bli tiltaksløs	doaimmahuvvat

bli tirret	áráskit

bli uklar	stulljašuvvat

bli velstående	jábálduvvat

bli verdiløs	árvvohuvvat

bli øm	árástuvvat

blikk-kontakt	čalbmeoktavuohta

blikkenslager	bellečeahppi

blikksaks	belleskárrit

blindkort	čieguskoarttat

blindnagle	popnávli

blindsone	jávkkohat

blindveg	luoddageahči

blinke til høyre	rávkalit olgešguvlui

blinke til venstre	rávkalit gurutguvlui

blodpropp, emboli	gillončoaltu, emboliija

blokkerende mindretall	caggi unnitlohku

blyakkumulator	ladjoakkumuláhtor

blyfri bensin	lajuhis bensiidna

blyholdig bensin	ladjobensiidna

blåhval	alitfális

blåsebelg	vuossu

blåsespiss	bossunnjunni

blåskjell	bohkkaguiski

blått lys	alit čuovga

blære	skoavhli

bløt grasmyr	leakša

bløtlodding	datnejugaheapmi

bløtt vann	mineralaálmmehis čáhci

bo- og driveplikt	ássan- ja doaimmahangeasku

boareal	ásodatareála

bobestyrer	oapmehálddašeaddji

boggi	sparru

boggibil	sparrobiila

boggilastgrense	sparroguoddinrádji

boggitrykk	sparrodeaddu

bogran	goavdeguossa

bohave	gándin

bokføringslov	ruhtadoalloláhka

bokført verdi	girjejuvvon árvu

boligeiendom	ásodatopmodat

boligstandard	orrundilli

boligtomt	viessosadji

bolivianer	bolivialaš

boltsaks	fápmočuohpan

bomasse	oapmelohka

bomveg	verrátluodda

bopel	ásodat
bopel	ássanbáiki

bordebakke	borbáhkku

borettslag	ásodatsearvi

borhylse	bovraskuohppu

borkile	luvvenlohti

bortfalle	nohkat

bortfallsgrunn	nohkansivva

bortforpaktningsadgang	lihttoláigohanlohpi

bortforpaktningskontrakt	lihttoláigohanšiehtadus

bosettingssone	ássanavádat

bostedsforbehold	ássaneaktu

bostyre	oapmestivra

bostyrer	oapmehálddašeaddji

botswaner	botswanalaš

brannbegrensning	buollineastta

brannbelastning	buollindeaddu

branncelle	buollinsealla

branngrav	boaldinhávdi

brannklasse	buollinjuohku

brannlag	buollángeardi

brannmann	jáddadeaddji

brannslokking	jáddadeapmi

brannslukkearbeid	čáskadanbargu, jáddadanbargu

brannslukkeinnsats	čáskadandoaibma
brannslukkeinnsats	čáskadandoaibma, jáddadandoaibma

brannslukkemannskap	jáddadeaddjit, čáskadeaddjit
brannslukkemannskap	čáskadeaddjit

brannslukkerarbeid	čáskadanbargu

brannslukkeutstyr	buollinčáskadanreaiddut

brannutvikling	buollima suohkun

brasilianer	brasillaš, brasilialaš

bratt skråning	ráhppat

bredt bord nederst i båten	čoavjefiellu

bregnerot	gáiskeruohtas

breiflabb	áhkábiddu

breiflabbyngel	kuntepillar

brekkjern	gákkan

bremsebånd	goazanbáddi

bremsekraftforsterker	goahcanfámu lasiheaddji

bremselengde	goazanmátki

bremselys	goazančuovga

bremsepedal	goazanduolmman

bremseskive	goahcanskearru

bremsesko	goahcangáma

bremsetrommel	goahcanfárppal

brennerutstyr	boaldinreaiddut

brennverdi	liekkasárvu

brent mark	roavvi

bringe inn	loktet
bringe inn	ovddidit

bringkoll	mielganjunni

brite	stuorrabritánnialaš, stuorrabritannialaš

brom	urbeoaksi

brudd i forhandlingene	šiehtadallanboatkaneapmi

bruddflate	doddjonolggoš

bruddspon	doddjonvuolahas

brukar	šaldejuolgi

brukbarhet	anolašvuohta

bruke benevnelsen far til noen	áhčástaddat

bruke penger betydningsløst	stajidit ruđa

bruksrettskrets	geavahanriektelaččat

bruksrettsutøvelse	geavahanriektedoaibma

bruksvann	geavahančáhci

brukt bil	adnon biila

bruneier	bruneidarussalamalaš, bruneilaš

brurele	náittosveaga bosihanbáikibáiki

bruttoavkastning	bruttodienas

brystning	ravdaáiddus

bryte loven	rihkkut lága

bråbremse	goazastit fáhkkestaga

bråkjøling	roahtačoaskudeapmi

bråstoppe	bisánit fáhkkestaga

brønnhus	gáivoskadja

budstikke	sátnegoahti

buffersone	dustenavádat

bukkemaskin	máhccunmašiidna

bukser	olgguldasbuvssat

bulgarer	bulgárialaš, bulgarialaš

bulimi	bulimiija

bumann	eanandoalli

bunden redskap	vihtanbivddus

bunnformasjon	botneneahku

bunnslepenot	bodnenuohtti

bunntipper	vuođusgurren fievru

bureising	ođđa doaluid álggaheapmi

bureisningsfelt	ođđadoallohuksenguovlu

bureisningstiltak	eanandoalloálggahandoaibma

burkiner	burkinafasolaš, burkinalaš

burundier	burundilaš

bussholdeplass	busseorustansadji

butikkparkering	gávpeorustansadji

byanlegg	gávpothuksehus

bygdeborg	gililadni

bygdevei	giligeaidnu

bygge på	vuođđudit

byggeplasstrafikk	huksensaji johtolat

byggfukt	viessolávttas, vistelávttas

bygningsdel	visteoassi

bygningsdrift	viessodoallan

bygningsruin	vistebázahus

bygningsvolum	vistegeassu

bygrunn	gávpotsadji

bygsel	eananláigoheapmi

bygselseddel	eananláigohanlihppu

bygsle bort	lihttoláigohit

bygård	gávpotdállu

bypassoperasjon	garvinčuohpahus, garvinčuohpadus

byprivilegie	gávpotovdamunni

byrdefull	eahpegovttolaš váttis

byttedyr	bivddáhas

byttevare	lonuhas

båndlegge	stirdudit
båndlegge	háldogáržžidit

båndlegging	stirdudeapmi

båndsliper	báddeliktenmašiidna, báddešliipa, sliipabáddemašiidna

båndtvangstid	gittadoallanáigi

båtbord	giellabordi

båtdrag	muotki

båtfeste	fanasgiddehat

båtfesterett	fanasláigovuoigatvuohta

båtfunn	fanasgávnnus

båtoppsett	sátku

båtstakevarp	čuoibmávárpi

bølgelengde	bárroguhkkodat

bølgetråd	fadnistráŋga

bøte garn, not	čiktit

bøte garn/ not	čivttašit

bøte på	njulget

bøte, bli bøtt	čiktásit

bøte, holde på med å bøte garn el. not	čiktáladdat

bøtegarn	čiktamas

bøtelegge	sáhkuhit

bøteregister	sáhkkoregisttar

bøtestraff	sáhkkoráŋggáštus

bøtetråd	čivttaárpu
bøtetråd	čikteárpu

campingvognplass	viessovovdnašillju

chatteprogram	neahttačálašanprográmma

cherimoya	cherimoija

chilener	chilelaš

chilipepper	chilibihpporat

choke	buváhat
choke	šohkka

cirkumduksjon	jorbodahkii ruvven

colombianer	colombialaš

costaricaner	costaricalaš

cottage cheese	govddidanmielki

cubaner	cubalaš

cupkjøring	čuoldinvuodjimat

cupmesterskap	čuoldinmeašttirvuodjimat

cupspill	čuoldingilvvut

cytologi	sitologiija

cytostatisk	sytostáhtta, seallamirku

daddel	dádel

dagjeldende	dallegustojeaddji

dagrovfugl	beaiveboraloddi

dagsverk	beaivvebargu

daktyl	daktyla

dalføre	rohči

damanlegg	buođđorusttet

damedusj	nissoniid riššu

dampmaskin	lievlamašiidna

danne seg knute	jarrut

danseseksjon	dánsenossodat

datadisiplin	diehtostivren

datakriminalitet	diehtorihkolašvuohta

dataliste	diehtolista

debitor	velggolaš

definisjonsmengde	vuođđodoahkki

degenerert	billohuvvan

dekkslast	bordeguorbmi

dekningslov	gokčanláhka

del av reinskallen	áksi

delbegrep	oassedoaba

delegasjonsbestemmelse	váldesirdinmearrádus

delegasjonslære	sirdinoahppa

delerøys	juohkourra

deltagerlov	searvanláhka

demningsveg	buođđoluodda

densitet	čoahkkisvuohta

deportasjonssted	rádjanbáiki

deputasjon	deputašuvdna

deputert	bálvá

desimaltegn	desimálamearka

det meningssøkende menneske	dárkkuhusa ozadeaddji olmmoš

det merkantilistiske system	gávpevuogádat

det offentlige	almmolaš eiseváldi

det å være far	áhččivuohta

detaljavvik	bienalaš spiehkastat

detaljhandel	smávvagávpi

detaljist	bođuidvuovdi

detaljistledd	smávvagávpedássi

diagonal	čađan

diagonaldekk	diagonáladeahkka

dialyse	dialiisa

dias	čuovgagovva

differanseinvestering	erohusinvesteren

differansekalkyle	erohusluoitu

differensial	differensiála

differensialsperre	differensiálgiddehat

differensieringsprosess	suorgásuvvan

differensiert	heivehuvvon

differensiert trafikknettverk	earuhuvvon johtolatgeinnodat

digitale læremidler	digitála oahpponeavvut

digresjon	áššis spiehkasteapmi

dikteringsmaskin	dikterenmašiidna

diktfigurer	diktafiguvrrat

dill	dilla

dimensjonert trafikkstrøm	merrejuvvon johtolathivvodat

diode	dioda

dip	buonjus

direkte kostnad	njuolggogollu

direkte lønn	njuolggo bálká

direkte materialforbruk	njuolggo ávnnasgeavaheapmi

direkte prosentregning	njuolggoproseantarehkenastin

direkte skatt	njuolggovearru

disambiguering	disambigueren

disiplinær	govssadoallan

diskett	diskeahtta

diskettstasjon	diskeahttastašuvdna

diskfeil	garraskearrus sivva

diskontere	diskonteret

diskonteringsfaktor	diskonterenbuvttadahkki

diskonteringsrente	diskonterenreantu

diskonto	diskonto

diskoskaster	skierrobálkesteaddji

diskurs	diskursa

disponering	oamasteapmi

disponeringsadgang	háldovejolašvuohta

disposisjon av foredrag	ovdasága juohku

disposisjonsbegrensning	háldoráddjen

disposisjonsmulighet	háldoveadju

dissenterende	mihtus

dissenterende votum	sierramielalaš jienasteapmi

distanseflytting	gáiddusjohtin

distinkt	oinnolaš

distribuere	juogadit

distriktsbidrag	guovlluoassi

distriktsingeniør	guovlluinšenevra

distriktsrevisor	guovllurevisora

divergense	erohus

divisjonskalkyle	divišuvdnaluoitu

djevelspytt	biručolga

djiboutier	djiboutilaš

djuptesnøre	sivlooarra
djuptesnøre	ravdabáddi

dobbel semitrailer	duppal semitráilar

dobbelklikke	deaddilastit guktii

dobbelsidig ulikhet	guovttegeardán vealla

dobbelt bokholderi	guovttegeardásaš girjedoallu

dobbelt midtlinje	duppal gaskasáhcu

dobbeltvirkende sylinder	guovttedoaimmat sylinddar

dockingstasjon	laktinvuoláš

dogglav	suoldnegatna

dokumentarforfatter	duohtagirjjálašvuođa čálli

dokumentarlitteratur	fáktágirjjálašvuohta

dokumentarskildring	duohtavuođaválddahallan

dokumentbevis	dokumeantaduođaštus

dokumenterbare	duođaštahtti

dolomittforekomst	dolomihttagávdnoštupmi

domene	domena

domfellelse	dubmen

domfelt	dubmehallon
domfelt	dubmejuvvon

dominant	ovddastalli

dominiker	dominicalaš
dominiker	dominikánadásseváldilaš

dommermyndighet	duopmárváldi

domsforkynnelse	duomu diehtunaddin
domsforkynnelse	duomugulaheapmi

domsgrunner	duopmovuođuštusat

domsmyndig	dubmenválddálaš

domsmyndighet	dubmenváldi

domspremiss	láhkaeaktu

domsresultat	dubmenboađus

domsslutning	duomu loahppamearrádus

domstolleder	duopmostuollojođiheaddji

domstolprøving	duopmostuolloiskkadeapmi

domstolsloven	duopmostuolloláhka

domstolspraksis	duopmostuollogeavat

domsutskrift	duopmočálus

dor	durra

dra nytte	ávkkárduvvat

dreiemoment	jorranmomeanta

dreier	várvvár

dreiestål	várvenstálli

drenering	čázehuhttin

drensvann	hilgojuvvon čáhci
drensvann	njielahatčáhci, hilgojuvvon čáhci, rufečáhci

drifts- og internregnskap	doaibma- ja siskkáldasrehketdoallu

driftshandling	doaibmadahku

driftshemmelighet	doaibmačiegusvuohta

driftsstans	doaibmaheaitin

driftssyklus	jahkodat

drivhuseffekt	šaddoviessobeaktu

drivpasning	čavgaheivehus

drivreim	jođihanruopma

drivverk	jođihandoaimmahat

droppe	luoitit

drøftelse	ságaškuššan

drøfting	ságaškuššan

dvergsnipe	uhcaviroš

dvergspett	uhcačáihni

dybdestøtte	maŋildoarjja

dynamitt	bávkkanas

dynamo	dynámo
dynamo	generáhtor

dyp kulp	áhpparaš

dyp utfor marbakken	gahččastat

dypet	seavdnjodat

dypt myrhull	jorbmi

dyr med bjelle	biellán

dyrefett	eallebuoidi

dyrehule	biedju

dyrestall	elliid báiki

dyrevernmessig	eallisuodjalan

dyrevernsnemnda	elliidsuodjalanlávdegoddi

dyrket mark	gilvojuvvon eanan

dyrkingsflate	šaddadanguolbba

dyrkingsspor	gilvvabázahus

dyse	cirggon

dysfunksjon	doaibmaváddu

dysse	geađgeáiggi geađgehávdi

dárogillii	sámegillii

dårlig motivasjon	heajos mokta

dårlig pris	hatteheapmi

dødballsituasjon	spábbavuolggahus

dødlinje	geahčerádjá

dødpunkt	jápmačuokkis

dødsbo	árbeoapmi
dødsbo	jápminbáhcu

døgnmulkt	beaivesáhkku

døgnopphold	jándordikšu

dømmende rett	dubmejeaddji riekti

dønning	siiga

ebbe	coahkut

ecuadorianer	ecuadorlaš

edelløvskog	alolastavuovdi

edelmetall	jállometálla

effektivitetsprinsipp	beaktilvuođaprinsihppa

eggvinkel	ávjočiehka

egypter	egyptalaš

eiedommelig	bunzar

eierløs	eaiggátkeahttá

einerlav	reatkájeagil

eksaminasjon	dutkkadeapmi

ekserpering	tearbmabargu, ekserperen

eksosanlegg	bázahasgássarusttet

eksosmåler	bázahasmihtádas

eksospotte	bázahasbohttu

eksosrør	liigegásarevre
eksosrør	bázahasbohcci

ekspansjonsbolt	báisaboaltu

ekspansjonshylse	báisaskuohppu

ekspedere	gárvvistit

ekspedisjonslokalitet	doaimmahatbáiki

eksportfilter	olggosfievrridansilli

ekspropiasjonsrettslig vern	bággolotnunriektesuodjalus

ekstensjonell definisjon, omfangsdefinisjon	joavkomeroštallan, ekstenšuvnnalaš meroštallan

ekstern regnskapsrapportering	olgguldas rehketdoalloalmmuhus

ekstraordinært møte	erenoamáščoahkkin

ekstraordinært rettsmiddel	earenoamáš riektegaskaoapmi

ekteskapsliknende	náitoslágan

ekteskapssak	náittosdilleášši

ekvatorialguineaner	ekváhtorguinealaš

ekvivalens	vástideaddjivuohta, vástideaddji tearbma, ekvivaleansa

elastan	elastána

elektrisk aggregat	rávdnjeaggregáhtta

elektronisk publikasjon	firebmepublikašuvdna, fierbmečálus

elementærladning	álgogealdu

elimineres	jávkaduvvot

ellipse	ellipsa

elvestrekning	johkaoassi

embetsdistrikt	virgeguovlu

embetsed	virgeválli

embetsforsømmelse	ámmátsuostan

embetsmannsbeskrivelse	ámmátolbmočilgehus

embetsmannsinnberetning	ámmátalbmádieđáhus

embetsstand	ámmátseahtu

embolus	embolus

emirataraber	ovttastuvvanarabaemiráhtalaš, arabaemiráhtalaš

emne til en vinterbelling	biddogámas

en halv mil	beanagullanbealli

endeklaringsvinkel	geahčegaskačiehka

endelig dom	loahpalaš duopmu

endeplanfres	geahčedulbenjurssan

endepunkt	geahčečuokkis

eneberettiget	oktovuoigaduvvon

enebolig	bearašásodat

energieffektivitet	energiijabeaktu

energiramme	energiijarámma

energirelaterte	energiijalaš

engasjementsordning	doaibmaalmmáiortnet

enkel term	oktonastearbma, eaŋkilis tearbma, aktonastearbma

enkelthet	oasáš

enkeltstående	sierra

enkeltvis	ovttaid mielde

ensidig mistanke	ovttabealát várohus

epos	epos

erfaringsmessig	virolaš

ergoterapi	ergodivššohat

eritreer	eritrealaš

erkebispesete	earkebismaguovddáš

erkjenne seg skyldig	dovddastit sivalažžan

erosjon	bátnegollan

erosjonssikring	gollansihkkarastin

erosjonsterrasse	gollanspáitu

erosjonsutredning	gollančielggadeapmi

erstatningsbetingende	buhtadanevttolaš

erstatningsfri	buhtadankeahttá

erstatningsrettslig	buhtadanrievttálaš

erstatningssak	buhtadusášši

erstatningsterapi	duddendikšu

ertepose	eartadiellu

erverve	háhkat

erverver	háhkki

ervervsmessig	dinendilálaš

essesveising	bádjesveisen

estlender	estteeatnanlaš, esttelaš

etableringsprovisjon	álggahanprovišuvdna

etiopier	etiopialaš

etsende	borri

etterforske	dutkat

etterforskingsskritt	dutkkalmasdahku

etterforskningsskritt	dutkkalmasdahku

etterforskningstiltak	dutkkalmasdoaibma

etterfølgende	maŋisčuovvu

ettergi	luoitit

etterlatt	oarbbis

etterleve	doahttalit

ettermæle	namma

etterprøve	dárkilastit

etterprøving	dárkkisteapmi

etterretning	šokčá

ettersyn	dárkkisteapmi, goziheapmi

etymologisk	etymologiijalaš

fagbevegelse	fágalihkadus

fagdommer	fágaduopmár

fagkyndig	fágadovdi

fagkyndighet	fágamáhttu

faktisk uvitenhet	duohtadili dovdama váili

faktiske utgifter	duohta olggosgolut

faktorsammensetning	dagaldatčoahkádus

fakultativ	molssaevttolaš

falle bort	nohkat

fallskade	gahččanlápmašupmi, gahččanlápmahuvvan

falsk anklage	vearresivahallan
falsk anklage	vearresivaheapmi

falsk forklaring	vearrečilgehus

falsskjøt	bontelakta

familie- og gruppeterapi	bearaš- ja joavkoterapiija

fangstekspedisjon	bivdomátkegoddi

fangstgrav	bivdoroggi

fangstinnretning	bivddus

fangstinnretning for fisk	guollebivdosat

fangstintensitet	bivdoárja

fangstlokalitet	bivdosadji

faresignal	várramearka, várrasignála

fartsbevis	johtinduođaštus

fasadekledning	julggabealskoađas

fasademateriale	julggabealávnnas

fast eiendom	giddodat

fast senterspiss	gitta guovddášnjunni

fast tilbehør	gittadávvir

faste kort	čadnon koarttat

fastlagt	mearriduvvon

fastlegge	mearridit

fastsetting	mearrideapmi

fegate	gudji

feiemulighet	ruhttenvejolašvuohta

feiteste del av kveitehodet	báldáuksu

fellende	sivalažžan cealkin
fellende	dubmehalli

fellesareal	oktasaš areála

feltspatbrudd	feltspáhtaláiggohat

fengselsmyndighet	giddagaseiseváldi

fengslet	fáŋga

fengsling	giddagassii bidjan

ferdigbehandle	válmmastit

fersk fisk	davraguolli

festeanordning	giddenráhkkanus

festenummer	eanaláigonummar, eananláigonummar

festmiddag	doallomállásat

festtale	doallosárdni

festtaler	doallosárdnideaddji

fijianer	fižilaš

filbehandler	fiilaozan

filippiner	filipiinnalaš

filt	duohppa

filtrering	duobussillen

finansieringsvirksomhetslov	ruhtadandoaibmaláhka

fisk i not	čavgehat

fiske med snik	sniikain bivdit

fiskebuk	čoavjjevuolli

fiskegjemme	guollečiehká

fiskeløs not	čáhcebahta

fiskemage	čoavji

fiste ballen	duvdilit spáppa

fjellfolding	báktemáhcci

fjellkam	šáhčir

fjello	láfol

fjellrein	duottarboazu

fjernavhør	gáiddusgažadeapmi

fjerning	eretdoalvun

fjernsynsovervåking	gáiddusgovvavákšun

fjernsynsteater	TV-čájálmas

fjerntliggende	gáiddus

flaskehalsenhet	boahtalčottaovttadat

flatmarksgrav	duolbahávdi

flatmeisel	duolbaluovččan

flatreim	duolbaruopma

flatstål	duolbastálli

flekksteinbit	bovlestáinnir

flerdelt	máŋggasuorat

flerordsterm	sátnelihttotearbma

flersidig	eanetbealát

flottør i enden av drivgarn	čoska

flussmiddel	šolgenávnnas

flyktig	lievllalaš

fløtingsanlegg	golgadanrusttet

fløtingsskjerm	golgadanláidehus

fløyel	luffel

folkerettsstridig	álbmotrievtti vuostá

folkevalgt organ	álbmotválljen orgána

folkevalgt representant	álbmotválljen áirras

foranledning	sudja

foranstående	namuhuvvon

forbeholden forklaring	doaladuvvon čilgehus

forbeholdent	doalada

forberedende behandling	ráhkkananmeannudeapmi

forbind	čatnat

forbinde med	laktit

forbrenningsskade	buollinroasmmohuvvan

forbrukerforhold	bođugeavaheaddjegaskavuohta

forbryte	rihkkut

forbrytersk	vearredagolaš

forbudt	gielddos

forbudt å svinge til høyre	olgeš guvlui vuodjingieldu

forbudt å svinge til venstre	gurut guvlui vuodjingieldu

fordre	vealgut

fordre gjelden betalt	bearrat vealggi

fordringshaver	vealgu

foreholde	deattuhit

foreldelsesfrist	áiggehuvvanmearreáigi

foreldet term	áigahaš tearbma

foreleggsstraff	sáhkkocealkkusráŋggáštus

foreliggende	árvaluvvon

foreløpig behandling	álgomeannudeapmi

foreløpig prøving	gaskaboddasaš geahččaleapmi

forenklet	álkiduvvon

forenklet forelegg	álkiduvvon sáhkku
forenklet forelegg	álkes sáhkkocealkkus
forenklet forelegg	álkes sáhkku

forenlig	soahppevaš

foreta	dahkat

forevise	čájehit

forevisningsfrist	čájehanáigemearri

forfall	áiban
forfall	mearrebeaivi

forfalske	vearidit

forferdigelse av klær	bivttasráhkadeapmi

forfølging	čuovvoleapmi

forfølgning	doarrideapmi

forføyning	mearrádus

forgjengetapp	álgodáhppa

forglemmelse	vajálduhttin

forgåelse	rihkus

forhale	healbadit

forhandlinger	šiehtadallamat

forhandlingsprosedyre	šiehtadallanlágasteapmi

forhandlingsutspill	šiehtadallanlihkastagat

forhandlingsveto	šiehtadallanveto

forhåndssorterer	álgosirren

forhåndsvarsel	ovdaalbmadeapmi

forhør	dutkkadus

forhørsdommer	dutkkadanduopmár

forhøyelse	eanedeapmi

forkalkes	gálkaluvvat

forklaringsplikt	čilgengeatnegasvuohta

forkontering	álgokonten

forkynning	gulahus

forliksklage	soabatráđđái vuoinnádus

forlikstilbud	soabatfálaldat

forlovede	lohpádallan guoibmi

formalisert	formaliserejuvvon

formildende omstendighet	geahppudeaddji dilli

forminskes	unniduvvot, uhccánit, unnánit, unnut

formuesgjenstand	árvoáhta

formuesgode	opmodatovdu

formuesverdi	oamastanárvu

fornærme på legemet	loavkašuhttit rupmaša

fornærmede	gillájeaddji

forretningsbanklov	gávpebáŋkoláhka

forretningsbrev	doaimmahusgirji

forretningssted	fitnodatbáiki

forringe	njeaidit

forringes	hedjonit, fuotnánit

forrådsgrop	biebmovuorkároggi

forsegle	seilet

forsegling	gokču

forsenkning	vuodjudanoaivi, vuodjudandearri
forsenkning	stealka

forsettelig drap	dáhtolas goddin

forsidefarge	pearpma ivdni

forsikringslov	dáhkádusláhka

forskningsøyemed	dutkama várás

forskudd	ovdamáksu

forskuddsbetaling	ovdamáksu

forskuttere	ovddalgihtii máksit

forslag til dagsorden	áššelistoevttohus

forspille	duššadit

forstander	jođiheaddji

forstørres	stuoriduvvot

forsvarlig handling	bealuštahtti dahku

forsvarlig opptreden	dohkálaš láhtten

forsyn på line	oarrskieddu

forsømmelig	suosttas

fortie	leat muitalkeahttá

fortrinnsvis	ovddemustá

fortrolig	guovttigaskasaš

fortsatt drift	doaibmajoatkin

forutgående	ráhkkaneaddji

forutsigelig	ávaštalli

forvaltningsrettslig	hálddašanrievttálaš

forvaring	rájus

forvarsling av stopp	bággobisáneami várrehus

forveksling	seahkaneapmi

forvolde	dagahit

forøve	dahkat

fossil	fossiila

fossilt	fossiillalaš

fostersøsken	biebmooarbinat

fotgrøft til gravhaug	hávdebirasroggi

fotrem	juolgebáddi

frafalle	hilgádit

frafalle ordet	eret cealkit sátnevuoru

frafallelse	hilgádus

fragå	gessojuvvo

framdrift	áššejohtu

framlegg	čálalaš evttohus

framlegge	ovddidit

framlegging	ovdanbuktin

frammøte	boahtin

framsette	ovddidit

franskmann, fransk	fránskalaš, frankriikalaš

frarådet term	hilggohastearbma

frasi	cealkit eret

fraskilt	earráneaddji

frasveising	eretsveisen

fratre	luohpat

fratreden	luohpan

fravende	váldit

fraværende	jávkan

fraværsdom	healbanduopmu

fraværsgrunn	healbanágga

fremkalle	buvttihit

fremkalt abort	cuovkanahttin

fremkomstmiddel	fievru

fremlegge	ovdandivvut

fremme en anke	ovddidit guoddaleami

fremmed stat	nubbi riika

fremmøte	boahtin

fremmøteforkynnelse	sierra gulaheapmi

fremre skinnebensmuskel	čuožžamasdeahkki

fremstilt	ráhkaduvvon

fremstå	orrut

fremtidsmulighet	boahtteáigevejolašvuohta

frese i smør	šnjirahit vuojas

fri bevisbedømmelse	friddja duođaštusárvvoštallan

fri bevisvurdering	friddja duođaštusmeroštallan

fri rettshjelp	nuvttá riekteveahkki

fri sakførsel	nuvttá áššejođiheapmi

frifinne	áššehuhttit
frifinne	čoavdit

frifinnelse	áššehuhttin
frifinnelse	áššehuvvon
frifinnelse	čoavdin

frifinnelsesdom	čoavdinduopmu

frifinnende	čoavdi

frigivelse	rahpan

frigivningsmyndighet	beassanváldi

frihetsberøvelse	friddjavuođarivven

frihetsinnskrenkning	manadangáržžádus

frihetsstraff	friddjavuođaráŋggáštus

frikjennelse	áššehuvvan

friske opp	varastit

fritaksregel	čoavdinregel

fritt	veaiddalis

fritt skjønn	friddja árvvoštus

fruktgrønnsak	šattosruonas

fukt	lávttas

fuktbelastning	lávttasváikkuhus

fuktbestandig	čáhcejeahkki

fullbyrde	ollašuhttit

fullbyrde lovbrudd	ollašuhttit láhkarihkkuma

fullbyrdelse	ollašuhttin
fullbyrdelse	ollašupmi

fullbyrdelsesdom	ollašuhttinduopmu

fullbyrdingsutsettelse	ráŋggáštusa maŋideapmi

fullmaktsforhold	fápmudusdilli

fullmektig	válddálaš

fullt regnskapspliktig	ollásit rehketdoallogeatnegas

fulltallig	dievaslohkosaš

fulltrailer	oppatráilar

funksjonshemmet	doaibmavádjit

funksjonssvikt	doaibmaváili

funnsted	gávdnanbáiki

fyldestgjørende	dievas

fylkesnemnd	fylkalávdegoddi

fyllestgjørende	dievasmahtti

fyllmiddel	notkkaldat

fyr	čuovgadoardna

fyrlykt	čuovgadoardnalámpá

fysisk funksjonshemmet	rumašlaččat doaibmavádjit

fysisk utviklingshemmet	rumašlaččat ovddádusvádjit

få garnet/ noten bøtt	čivttihit

få i oppdrag	bijahallat

få skrens	šleaŋgasit

få til å gå i garn eller not	čákŋadit

følge protokoll	čuovvut vieru

føre bevis	duođaštallat

føre dokumentbevis	lágidit dokumeantaduođaštus

føre en sak	jođihit ášši

føre fram	juoksut

føre referat	čállit čoahkkingirjji

førehandsvising	ovdačájeheapmi

førerkort klasse C	vuodjingoarta klássa C

førerkort klasse CE	vuodjingoarta klássa CE

førskolepedagogisk avdeling	ovdaskuvlapedagogalaš ossodat

første instans	vuosttaš instánsa

første omgang	álgovuorru

førstekrigsadvokat	baijit soahteadvokáhtta

førstelagmann	vuosttaslágamánni

førstestatsadvokat	vuosttasstáhtaadvokáhtta

gaboner	gabonlaš

galaktose	galaktosa

gambier	gambialaš

gammel hevd	doloža rájes geavaheapmi

gammetuft	goahtesadji

gardfar	geađgeáidebázahus

garnbøting	čiktin

garnforbindelse	čavgamoardda

garnstein	buddogeađgi

gassformig	gássalágán

gasstenner	čuonancahkkehat

gate gjennom boligområde	ássanguovllu gáhtta

gateselger	šiljus vuovdaleaddji

gattåpning	čoallegeahči

geil	gudji

generasjonsbolig	buolvvaid ásodat

generisk begrepsrelasjon	generálalaš doabagaskavuohta

georgier	georgialaš

gesimshøyde	nurkeallodat

ghaneser	ghanalaš

gi avkall på	luohpat

gi detaljert beskjed	bagadallat

gi mellomlegg ved bytting	bajálastit

gjeldende rett	gustojeaddji riekti

gjeldende siffer	gustojeaddji siffer, gustojeaddji nummar

gjenfangstrett	bivdovuoigatvuohta

gjengivelse	jievžan

gjenkallelig	máhcahahtti

gjenkjennelse	dovdájupmi

gjennomfartsgate	čađajohtingáhtta

gjennomfartsveg	čađajohtinluodda

gjennomføringsprosedyre	čađahanlágasteapmi

gjennomføringstiltak	čađahandoaibma

gjennomføringsvedtak	čađahanmearrádus

gjennomgåelse	čađalohkan

gjennomgående	čađamanni

gjennomstrømmingsmåler	čađagolganmihtádas

gjennomsyn	geahčadeapmi

gjenoppta	rahpat ođđasit

gjenopptakelse	ođđasisrahpan

gjenstart	álggahit ođđasit

gjentagelse	ođadeapmi

gjentagelsestilfelle	ođadandilli

gjentakelsesfare	geardduhanvárra

gjentakelsesstraff	ođadanráŋggáštus

gjenutnevning	ođđasisnammadeapmi

gjenvinning	ođđasit ávkkástallan

gjenværende bokførte verdi	báhcán girjejuvvon árvu

gjenåpne	veaddjáhit

gjenåpning	veaddjáheapmi

gjenåpningsdomstol	veaddjáhanduopmostuollu

gjør slik	daga ná

gjøre at noe blir rimbelagt	bihcudit

gjøre at noe forsvinner	áibadit

gjøre innsnitt på	bohkket

glitter, juletreglitter	juovlamuoidu, šealggobáddi, juovlamuorbáddi

gluten	glutena, gordnevielgadas

gluttsnipe	stuorračoavžžu

glyelav	njivlojeagil

glødeskall	áhcagastingarra

god regnskapsskikk	buorre rehketdoallodáhpi

gods	gálvu

godsbygning	gálvovisti

godt hold	állu

godt utseende	álolaš

godter	njálgát

godtroerverv	dan oskkus háhkan
godtroerverv	vierihismielain  háhkan

gradvinkel	čiehkamihtádas

gransanger	skilkeskálka

granskingsforretning	dutkkadanášši

granskingskommisjon	dutkankommišuvdna

graverende	bahás

graveringsstikkel	girjjuhančálán, girjjuhansággi

gravfelt	hávdebáiki

gravhaug	hávdeboldni

gravlund	girkogárdi

gravrøys	hávdeborra

gravørkule	girjjuhanstáđđi, girjjuhankuvlla

grenadier	grenadalaš

gresskar	gurbbet

gresstorv	lavdnji

grophus	roggeskadja

grov legemsbeskadigelse	roava rumašvahágahttin

grovfor	roavvafuođđar

grovvurdering	álgoárvvoštallan

grunnboksblad	eananregisttarbláđđi, eanaregisttarbláđđi

grunnforhold	eanačoahkku, eanančoahkku

grunngi	vuođuštit

grunnhåv	vuođđohoavva

grunnløs	vuođuheapme

gruppemedlem	joavkolahttu

gruppeprosess	joavkoproseassa

grupper som holder til på en øy	suolohasat

grupperegister	joavkoregisttar

grupperepresentant	joavkoovddasteaddji

grusoverflate	čievraassi

gruve, alle typer	ruvke, buot lágánat

gråtrost	ránesrásttis

grønnforvekst	ruonasfuođđar

grønnsisik	ruonácizáš

grønnstilk	ruonájuolčoavžžu

guanofabrikk	goanstaduktaráhkadandoaimmahat

guatemalaner	guatemalalaš

guineaner	guinealaš

gulsanger	fiskesjievžžan

gulskinn	fiskesjeagil

gummiasfalt	gummiasfálta

gunst	oidu

guyaner	guyanalaš

gyldig filnavn	dohkálaš fiilanamma

gyldig stemme	dohkálaš jietna

gyldig vedtak	dohkálaš mearrádus

gå an	soabastuvvat

gå i garn eller not	čákŋat

gå i garn/ not	čuohcalit

gå til sak	čuoččaldahttit ášši

gå-grense	čáhkanrádji

gårdshaug	dálločopma
gårdshaug	duvdnečopma

gårdsplan	eanadássi

gårdsplassen	šillju

gårdstun	dállošillju

ha arbeidslyst	barggastuvvat

ha samleie	anašit

hagesanger	rohtovizar

haitier	haitilaš

hallusinasjon	hallusinašuvdna

halvleder	beallejođadas

halvrundfil	beallejorbafiilu

halvskattelapp	beallevearrosápmi

handelsanlegg	gávpeásahus

handelsforordning, oktroi	gávpenjuolggadus

handelsprivilegie	gávpeovdamunni

handlingstidspunkt	dahkanáigi
handlingstidspunkt	dagu áigi

hands	gieđasteapmi

hard nakkekrave	čeabetstielgu

hardt vann	mineralaálbmás čáhci

harmonisert	oktiiheivehuvvon

harpunkanon	árenkanovdna

havbotn	ábi bodni

havert	ránesnjuorju

havnegang	láidun

havneområde	hámmanbiras

havrek	áhpehilggohas

havsnød	áhpeheahti

havsvale	áhpespálfu

heading	bajilčála

hedensk	báhkinlaš

heimrast	lagašmeahcci

heipiplerke	niitocivkkán

helbred	dearvvasvuohta

hele og fulle sannhet	ollislaš duohtavuohta

helgedagsgodtgjørelse	bassebeaibuhtadus

helhetsbegrep	ollisvuođadoaba

hellekiste	ráktohávdi

hellemaleri	báktenjuohtan

hellig fjell	bassi várri

hellig sted	bassi báiki

helse- og sosialadministrasjon	dearvvašvuođa- ja sosiálhálddahus

helse- og sosialetaten	dearvvašvuođa- ja sosiálossodat

helse- og sosialsjef	dearvvašvuođa- ja sosiálhoavda

helskattelapp	ollesvearrosápmi

helårsfiske	jahkodatbivdu

hematologi	hematologiija

hematom	hematoma

hemmelig votering	čiegus jienasteapmi

hemmeligholde	čihkosis doallat

hemofili	vardindávda, hemofiliija

henholde seg	doalahit

henholdsvis	sihke

henlegge	heaittihit

henleggelse	heaittiheapmi

hensiktsmessighets skjønn	ávkkálašvuođa árvvošteapmi

hensynsfull	deasttalaš

hercegovin​er, bosnier, hercegoviner	bosnialaš, bosniahercegovinalaš

herdelim	buoššodanliibma

herdeovn	buoššodanomman

herding	buoššodeapmi

herretoalett	dievdduid hivsset

heve kjøpet	dahkat ruovttugávppi

heving	loahpaheapmi

himling	robevuolli, dáhkkevuolli

hindres	heađuštuvvot

historieforfalskning	historjávearistus

historisk arkeologisk lokalitet	historjjálaš arkeologalaš báiki

historisk redegjørelse	historjjálaš čielggadeapmi

historisk-biografisk metode	historjjá-biografiija suorgi

hjelpedokument	veahkkedokumeanta

hjelpefengsel	veahkkegiddagas

hjelpekrigsadvokat	vuolit soahteadvokáhtta

hjelpestatsadvokat	veahkkestáhtaadvokáhtta

hjemmemark	ruovttugieddi

hjerteskjell	bohccoskálžu

hjullaster	juvlagoivvon

hjørnefelt	čiehkabáiki

hjørnepunkt	čiehka

hodeeksem	oaiveasibostta

holde møte for lukkede dører	čoahkkima doallat gitta uvssaid

holde seg til saken	čuovvut ášši

holder	doalan

holdes à jour	ođasmahttot

homonymi	homonymiija

honduraner	honduraslaš

hoppbakke	njuikehat

horisontalfresemaskin	vealujursanmášiidna

horisontalplan	láskkodássi

horisontalt	láskut

horn og metallsløyd	čoarve- ja metálladuodji

hornforsenkning	čoarvestealka

hovedanke	váldoguoddaleapmi

hovedbygning	váldovisti

hovedbæresystem	váldoriggi

hovedledning	váldobohcci

hovedregler	váldonjuolggadusat

hovedstraff	váldoráŋggáštus

hovedvilt	oaivebivddáhas

hoveri	bággobargu

hulemaleri	báktelatnjanjuohtan

hull i havbotn	áhpparas

hulvei	gobagan geaidnu

humanitær institusjon	humániteara ásahus

hundredel	čuođádas

husdyr som står bundet	báddegeaššibit

husmannsplass	láigodállosadji

hvalfangst	bossubivdu

hvileplan	vuoiŋŋastanaski, gaskadássi

hvilepuls	muosseravkkas

hviterusser	vilgesruošša, vilgesruoššalaš

hyppig vannlating	čáhcevuojahat

hyre	bargu fatnasis

håkjerringjuksa	áhkalakkisgiehtaváđđu

håløygsk høvding	håløygalaš oaivámuš

håndlist	doallanlistu, dorjenravda
håndlist	dorjenravda

håndrem	giehtabáddi

håndteres	gieđahallojuvvot

håndtverker	duojár

håndverker	duojár

hørselskadelig	gulluvahátlaš, gulluvahágahtti

høy oppløsning	alla čilgodat

høy straff	garra ráŋggáštus

høyesteretts kjæremålsutvalg	alimusrievtti váiddagoddi

høyesterettssak	alimusriekteášši

høyrepil	olgešnjuolla

høyretrafikk	olgeš johtolat

i etterforskningsøyemed	dutkkalmasa várás

iakttakelse	čuovvun

identifikasjonsnummer	dovdonummir

idrettsbane	valáštallanšillju

idømme	dubmet

idømmelse	dubmen

ikke skyldig	sivaheapme

ikke straffbar handling	ráŋggáškeahtes dahku

ikke straffbart forhold	ráŋggáškeahtes dilli

ikon	bassi govva

ildsted for vedfyring	dolastansadji

ilegge	mearridit

immaterialrettighet	vuoiŋŋalaš vuoigatvuohta

impedimentandel	impedimentoassi

implantat	dahkubátni

importere	sisafievrridit

importfiler	sisafievrridansilli

importmelding	buktinalmmuhus

imøtegå	dusttodit

inaktiv gass	doaimmahis gássa

inder	indialaš

indirekte skatt	čuovvu vearru

individualbegrep	ovttaskas doaba, individuála doaba

individualiserende	oktagas

individuelt søksmål	oktasaslaš čuoččaldat

indonesier	indonesialaš

indre lager	dihtorsiskkáldasrájus

indre sirkeldefinisjon	siskkáldas jorusmeroštallan

infarkt	infárkta

informasjonsskranke	diehtojuohkinbordi

injeksjon	cirgun

injektor	cirgoventiila

inkassobevillingsinnehaver	bággobearri

inkassooppdrag	bággobearramuš

inkontinens	inkontineansa

inkontinens madrass	čáhcejeahkki guoddá

inkorporasjonsbestemmelse	ovttastahttinmearrádus

innbrudd	gaikun

innbygging	sisahuksen

inndata	dihtorbiebmu

inndra	gihppet
inndra	konfiskeret

inndraging	konfiskeren

inndragning	gihppen

inndragningsansvar	duoguštanvástu

inndrive	bearrat

inndriving	bearran

inneluft	sisáibmu

innemiljø	sisbiras

innfartstrafikk	boahtinjohtolat

inngi	ovddidit

inngrepstid	čuohppanáigi

inngående beholdning	álgorádju

innholdsdefinisjon, intensjonell definisjon	doabasisdoalu meroštallan, intenšuvnnalaš definišuvdna

innkapsles	birastahttojuvvot

innledningsforedrag	álggahanovdasáhka
innledningsforedrag	álgočilgehus

innlegge	sajuštit

innleggelse	ásahusas orrun
innleggelse	sajušteapmi

innlesingsenhet	dihtorbiebmanovttadat

innovere	ođastit

innrede	bierggastit lanja

innsatt	fáŋga

innsending	sádden

innskrenkende	gáržžideaddji

innskrift, ristning	sárgun, čálus

innskrifter, runer	sárgumat, runat

innskrive	čálihit

innsnevring	bohki

innstevne	stevdnet

innstille	doaladit
innstille	bissehit

innstillingsvinkel	čuohppanávjučiehka

innta	gihppet
innta	guoddit

inntekts- og utgiftsverdi	boahto- ja golloárvu

inntektsgivende virksomhet	dienasaddi doaibma

inntektsoppgave	boahtodieđáhus

inntre	deaividit
inntre	loaidat
inntre	šaddat

inntrinn	bátnečikŋodat, ceahkkečikŋodat

intensitet	intensiteahtta, allavuoimmálašvuohta, vuoimmálašvuohta

intensjon, begrepsinnhold	intenšuvdna, doabasisdoallu

intern regnskapsrapportering	siskkáldas rehketdoalloalmmuhus

internt fjernsyn	siskkáldas-TV

internvarme	siskkáldasliekkas

iraker	iraklaš

iraner	iranlaš

irlender, ire	irlándalaš

isdam	jiekŋavieččahat

ise	jiekkaldit

ising	bátnejiekkaldeapmi

islandslav	sarvajeagil

isolasjons sengepost	sierranahttinseaŋgalanjat

isolasjonspost	sierranahttinlanjat

isolator	erreldat

isolerband	errenbáddi

isolering	sierranastin
isolering	sirren
isolering	guđjen

isoleringsmastriks	sáttoseaguhus

israeler	israellaš

ivaretaking	áimmahuššan

ivorianer	elefántabátneriddulaš, elfenbátneriddulaš

jakt- og fangstkultur	bivdo- ja johtalankultuvra

jaktpremie	báhčinbálká

jamaikaner, jamaicaner	jamaicalaš

jamsides	bálddalaga

japaner	japanlaš

jekk	duŋke

jemenitt	jemenlaš

jernbaneanlegg	ruovdemáđiirusttet

jernbanebru	ruovdemáđii šaldi

jernbaneminne	ruovdemáđiibázahus

jernvinneanlegg	ruovdebuvttadanráhkadus

jernvinneovn	ruovdesuddadanomman

jordaner	jordanialaš

jordugle	bumpaloddi

juridiksjon	duopmováldi

kald vind fra øst	beavža

kalkovn	kálkaomman

kam med håndtak	čohkkundoalan

kambodsjaner	kambodjalaš

kameralvesen	kameráldoaimmahat

kameruner	kamerunlaš

kanadier	kanádalaš, kanadalaš

kapasitetsbegrensning	boahtalčotta

kapers	kapers

kapitalinteresse	ruhtaberoštupmi

kapitalsterk investor	ruhtaluvvejeaddji

kappverder	kapverdelaš

karbohydrat	karbohydráhta

kardiogram	kardiográmma

kardiolog	váibmodoavttir, kardiologa, váibmospesialista

karies	bátnemieskan

kasakhstaner	kazakstanlaš

kastenot	bálkestannuohtti

kausjon	dáhkideapmi

kausjonist	ruhtadáhkideaddji

kavlebru	rovvi

kavvelbensel	buhtet

keipbånd	ákŋobáddi

kenyaner	kenialaš

kineser	kiinnálaš

kirgiser	kirgistanlaš

kiribatier	kiribatilaš

kirkegårdslokalitet	girkogárdebáiki

kirkegårdsmur	girkogárdemuvra

kirketuft	girkosadji

kjedemelding	gilvinteakstadiehtu

kjemisk rens	kemiijalaš bassan

kjenne skyldig	cealkit sivalažžan

kjeve	badjeoalul

kjone	goikadanvisti

kjølebehov	čoaskudandárbu

kjølegrop	čoaskudanroggi

kjølesystemtester	čoaskudanrusttetiskan

kjølevann	čoaskudannjalbi

kjønnslemlestelse	vuolledábiid vahágahttin

kjøpeløyve	oastinlohpi

kjøpmannskompani	gávpejassearvi

kjørbar	vuojihahtti

kjøreretning	vuodjinguovlu

kjørvel	kervel

klandreverdig	moaittehahtti

klappmyss	arktalaš njuorju

klargjøre	válbmet

klarlegge	čielggadit

klemhylse	čárvenskuohppu

klemjern	čárvenruovdi

klemme, skrutvinge	niibenađđačavggan, niibenáđđacivccon

klemming	bahkašupmi

klimatisk skjermet miljø	suodjebáiki

klimatiske forhold	dálkkádagat

kloakkledning	kloáhkkajođas, duolvačáhcebohcci, duolvačáhcejođas

kloakkplan	kloáhkkaplána

kloster	kloster

klosteranlegg	kloasttarráhkadus

klosterprivilegie	klostersierralohpi

kneskinne	čibbestielgu

knockout dråper	dárpmehuhttinmirku

knottstøvel	culcegáma

knute, klump	čuolbma

koble til, anslutte	goallostit

kokegrop	vuoššanroggi

kokegroplokalitet	vuoššanroggesadji

koksteinsforekomst	árrangeađgegávdnoštupmi

koksteinsrøys	árrangeađgeguhpá

kolesterol	kolesterola

kollektiv innehållsproduktion	buvttadit searvvušlalaččat  sisdoalu, buvttadit searválagaid sisdoalu

kollektivfelt for buss	bussiid oktasašjuohku

kollektivfelt for buss og drosje	bussiid ja taxiid oktasašjuohku

kolonihage	láigogilvvagárddáš

komfortopplevelse	sulolašvuođadovdu

komme i mindretall	šaddat unnitlohkui

komme opp til diskusjon	šaddat digaštallot

komme til enighet	šiehttat

kommunehelsetjenesteloven	gielddadearvvašvuođabálvalusláhka

kommuneintern sentralisering	suohkansiskkáldas čoahkkanandoaibma

kommunikasjonskontroll	gulahallangoziheapmi

kommunikasjonsvei	johtalangeaidnu

komorer	komorlaš

kompassrose	kompássaruvsu

kompleksitet	mohkkáivuohta

komplementær	ollisteaddji

komprimere	čárvet

konfidensialitet	luhtolašvuohta

konfliktgrad	riidomuddu

kongehuset	gonagasgoddi

kongoleser	kongolaš

konjunktursvingning	áigodatnuppástuhttin

konkurransemessig	gilvvolaš

konkursbehandling	konkursameannudeapmi

konkursdebitor	konkursavelggolaš

konkurskreditor	konkursavelgoheaddji

konkursåpning	konkursarahpan

konpinne	čohkkosággi

konsekvens-utredningsfase	čuozahus-čielggadanmuddu

konsentrasjonsevne	áicilvuohta

konsentrert	čoahki

konseptpapir	álgočálusbábir

konstruksjonssikkerhet	ráhkadussihkkarvuohta, huksehussihkkarvuohta

kontaktundervisning	kontáktaoahpahus

kontentum	duogášjienat

kontradiksjonsprinsippet	kontradikšuvdnaprinsihppa

kontraktsevne	šiehtadanvuoigatvuohta

kontraktsforhold	šiehtadusdilli

kontraktsforutsetning	šiehtaduseaktu

kontravotere	vuostejienastit

kontroll i byggesaker	huksenáššiid dárkkisteapmi

kontrollkommisjon	gozihanlávdegoddi

kontroversielt spørsmål	riidogažaldat

kopla til	čatnat neahttaoktavuođa

korporal	korporála

korpus	korpus

korrespondenttegn	čállimearka

korrespondere	čálašit

kost og mask	dievas hárjehallan

kraft i mat	álbmi

kraftforblanding	jáfoseagáš

kraftproduksjons potensiale	fápmobuvttadan vejolašvuohta

kraftstasjon	elfápmodoaimmahat

krav om heis	vintagáibádus, fintagáibádus

kreftfremkallende	karsinogena

krenkelse	rihkkun

krenkende	rihkolaš

kretsmønster	gevlo

kreve sterkt	bearrat

krigsadvokat	soahteadvokáhtta

krigsminnelokalitet	soahtemuitobáiki

krigsskueplass	soahtešillju

kriminalomsorg	vearredahkkiid váitta
kriminalomsorg	rihkusfuolahus

kriminell	kriminála

kriminell lavalder	kriminála vuolleahki

kriseforanstaltning	heahtedoaibma

kritisk verdi	birzeárvu

kronologi	áigelohku

kronologisk arkiv	áigeortnetarkiiva

krum del mellom kjøl og stavn på båt	bárdi

krumpasser	boaggemihttu

krympe	duohpahuvvat

kryss skrutrekker	ruossaskruvvabonjan, ruossaskruvabonjan, ruossaskruvvaruovdi

krysskrue	ruossaskruvva, ruossaskruva

kryssubsidiering	duppalruhtaveahkki

kuldeanlegg	galmmihanrusttet

kuldebro	liekkassuola

kullforekomst	čitnagávdnoštupmi

kullgrop	čitnaroggi

kullgruve	koallaruvke

kullhaug	čitnaguhpa

kulturbeite	gilvojuvvon gieddi

kulturbetingede	kultureaktudeaddji

kulturlag	kulturgeardi

kultuveringsanlegg	dikšunrusttet

kunnskapsbase	diehtogáldu

kuttdybde	čuohppančikŋodat

kutteskive	čuohppanskearru

kuwaiter	kuwaitlaš

kvadratmeter	njealjehasmehtar

kvalifisert	máhttádan

kvalifisert flertall	arvat eanetlohku

kvartbekkasin	uhcameahkástat

kveiteangel	bálddisvuogga

kveiteline	báldávuorra

kvinnelig eventyrskikkelse	áhčešeatni

kvitkrull	oaivejeagil

kyndighet	áššemáhttu

kypriot	kyproslaš

labyrint	labyrinta

lagerbygning	rádjovisti

lagerkartotek	rádjokartotehka

lagmann	lágamánni

lagre som	vurke nugo

lagres	ráddjot, vurkejuvvot, ráddjojuvvot

lagrettemedlem	jurylahttu

lagringsopplegg	rádjanláhki, rádjanvuohki, vurkenvuohki

laksestengselinngang	čuollonjálbmi

laktose	laktosa, mielkesohkar

landboreform	boaittobealođastus

landevegskjøring	doaresbealluotta vuodjin

landmåler utparsellering	eanamihtidaneanabihttá

langtrukken debatt	áddjás digaštallan

laot	laoslaš

lastbærer	guorbmedoalli

latrine	olgohivsset

latvier	latvialaš

lavalder	vuolleahki

lavt oppløselig	vuollegis čilgodat

lede til	dagahit

ledegarnstolpe	čuolločuolda

ledegjerde	seiboš, seaibbuš

ledesystem	čuovuhanvuogádat

ledningstrase	jođasspáitu

ledsagerprogram	mielčuovvuide prográmma

legdommer	álbmotduopmár

legemsbeskadigelse	rumašvahágahttin

legemsfornærmelse	rumašloavkadeapmi
legemsfornærmelse	rumašloavkašuhttin

legemskrenkelse	rumašrihkkun
legemskrenkelse	rumašrihkus

legemsskade	albmasuoigi
legemsskade	rumašvahát

legemsundersøkelse	rumašiskkus

leggbeskytter	suddjenbiddi

leidang	mearrasoahteveahka

leidangskatt	leidangvearru

leider	bádderáidalas

lekebåt	cuggu

lekkasjevann	lahcáčáhci

lempe på	ložžet

lengden på garnet, øverste del	čoalli

lenstid	leanaáigi

lesothoer	lesotholaš

leveringsbil	buktinbiila

libaneser	libanonlaš

liberier	liberialaš

libyer	libyalaš

lide skade	vaháguvvat

liechtensteiner	liechtensteinlaš

ligningslov	livnnetláhka

ligningsoppgjør	livnnetalmmuhus

likeartet	ovttalunddot

likebehandle	dássidit meannudit

likkvile	liikafáru vuoiŋŋastansadji

limpistol	báhkkaliibmapistovla, liibmapistovla

linjediagram	linnjádiagrámma

linjedommer	leavgaduopmár

linjenett	linnjáfierpmádat

listerbåt	bordefanas

litauer	lietuvalaš

lite barn	mánáš

liten bøtenål	čiktingeahpa

liten far	áhčáš

liten forskjell mellom flo og fjære	smávvačáhci

liten øks	ákšogilka

livsforhold	eallindilli

loddeier	oasseeaiggát

loddeinnsig	šákšamárran

loddrett pil	ceakkonjuolla

loddtrekning	vuorbádus

logge inn	čállit sisa

lokal herredsrett	báikkálaš gielddariekti

lokal kollektivtrafikk	báikkalaš fárrolatjohtolat

lokal telefon	lagaštelefuvdna

lokalgate	báikkálaš gáhtta

lokaltelefonsamtale	báikkálaš telefonságastallan

lokaltrafikk	báikkálaš johtolat

lokalveg	báikkalaš luodda

lommekniv	máhcceniibi, lađasniibi, máhcastatniibi

lov om folkehøyskoler	álbmotallaskuvlaláhka

lov om forsvarshemmeligheter	láhka suodjalusčiegusvuođaid birra

lov om rettergangsmåte	láhka lágastanvuogi birra

lovanvendelse	láhkageavaheapmi

lovbestemt	lágalaš

lovbryter	láhkarihkku

lovendring	láhkarievdadeapmi
lovendring	láhkarievdadus

lovhjemmel	láhkavuođđu

lovovertredelse	láhkarihkkun

lovstridig	lágavuosttas

lovtolking	láhkadulkon

luftblære	áibmoskoavdi

lufterør	áibmobohcci
lufterør	biggohanbohcci, áibmobohcci

luftføring	áibmofievrrideapmi

lufthavnselskap	girdišilljofitnodat

luftkvalitet	áibmodássi

luftlyd	áibmojietna

lunsjrom	boradanlatnja

lupus erythematosus	SLE, Lupus

luxemburger	luxemburglaš

lydabsorpsjonsegenskap	jietnadusteniešvuohta

lyder som følger	čuodjá ná

lydkassett	jietnakaseahtta

lynnedslag	álddagasgaskin
lynnedslag	álddagasgaskkastat, álddagasgaskin

lysbildeapparat	čuovgagovvarusttet

lysbotn	čuovgabodni

lysbue	čuovgadávgi

lysing	gulaheapmi

lysnett	čuovgafierpmádat

lystrejern	áren

lånt term	loatnatearbma

læge	livvasadji ja skadjá

læremidler	oahpponeavvut

løfteplattform	loktenlávdi

lønns- og regnskapsmedarbeider	bálká- ja rehketdoallomielbargi

lønns- og trekkoppgave	bálká- ja geassindieđáhus

lønnsarbeider	bálkkolaš

løpekatt	doaresbielkávávdna

løpekran	doaresbielkálovtton

løpende mulkt	ollašuhttinsáhkku

løpende pris	dáláhaddi

løs snø	lotkes muohta

løsemiddelspray	luvvadancirggon

løsfunn	luovosgávnnus

løslate	luoitit

løslatelse	luoitin

løsmasse	mássaluovus

løsøre	luvvodat

løvmeis	rohtogaccet

løyveplikt	doaibmageatnegasvuohta

madagasser	madagaskarlaš

makrell i tomatsaus	onjusmakrealla

makrellterne	guollečearret

maksimalkulør	dievasivdnádat

maksimalt	eanemusat

maksimaltakst	badjerádjemearri

maksimumsstraff	maksimaráŋggáštus

malawier	malawilaš

malaysier	malaysialaš

maldiver	maledivalaš

malier	malilaš

malmlager	málbmavuorká

malmvei	málbmageaidnu

malt til øl	vuolamálddis

malteser	maltalaš

maltose	maltosa

mangeromstuft	máŋggalanjat duktásadji

mangfoldiggjøre	máŋget

mannsbellinger	gálssohat

manøverknapp	stivrenboallu

marbakke	beaŋká

margebein	čuožžamas

marinebase	mearamilitearguovddáš

marinefartøy	militearafanas

marint løsfunn	mearragávnnus

marmelade	meastta

marokkaner	marokkolaš

marshalleser	marshallsuolohas

masovn	másomman

massebilisme	álbmotbilisma

massemedia	mediahivvodat

massemøte	álbmotčoahkkin

mateaksel	borahanáksil

matehjul	caggejuvla

matematikk lager	matematihka oahpponeavvut

materialavhengig kostnad	ávnnassorjavaš gollu

materialbod	ávnnasvurkkohat

materiellrettslig	ávnnasrievttálaš

mateskrue	borahanskruvva

matrikkelnummer	matrikkelnummar

matrikulert jord	čálihuvvon eanan

mauritanier	mauritanialaš

mauriter	mauritiuslaš

meddelelse	dieđiheapmi
meddelelse	diehtu

medgå	váret

medhold	veajiheapmi

mediatek	medialatnja

medregne	lohkkot

medskyldig	sivvaoasálaš

medundertegne	mielvuolláičállit

megle	soabahit

meklingsmann	soabahalli

meksikaner	mexicolaš

melatonin	melatoniidna

melde seg ut av	cealkit eret miellahttuvuođa

melkegrop	mielkeroggi

melkeplass	bohčinsadji

melketange	bohčinsadji

mellomrom, tomrom	gaska

menneskerettslov	olmmošvuoigatvuođaláhka

mentalobservasjon	miella áican

merkekrav	merkengáibádus

merkestein	mearkageađgi

merverdiavgiftslov	lassiárvodivatláhka

meslinger	bárkodávda

metalloppheng	šlimbbar

midlertidig brukstillatelse	gaskaboddosaš geavahanlohpi

midlertidig forføyning	gaskaboddosaš mearrádus

midtlinje	guovddášsárggis

midtstrømslinje	guovdorávdnjeoalli

mikrobiologi	mikrobiologiija

mikrofilm	mikrofilbma

mikronesier	mikronesialaš

mildeste måte	láđđásamos vuohki

militær straffelov	militeara ráŋggáštusláhka

militære myndigheter	militára eiseválddit

militærkolonne	militeararáidovuodjin

militærstell	militearafuolahus

miljø- og helseproblemer	biras- ja dearvvašvuođaváttisvuođat

mindre alvorlig	uhcit duođalaš

mindre høyderygg	čorru

minnelig	dáhtolaš

minnelig ordning	soabatlaš čoavddus

minnelighet	dáhtolašvuohta

minnepinne	muitosággi

misbruke	rohcošit
misbruke	veret
misbruke	beahttit

misforhold	gorihisvuohta

mistenkes	várohuvvot

mistenkt	várohuvvon

mobildata	mobiiladata

modifisert	váidudeaddji

moldover	moldovalaš

monegasker	monacolaš

mongol	mongolialaš

monosakkarid	monosakkariida

montenegriner	montenegrolaš

mopp	riesagušta

mortifikasjon	jámiheapmi

mosambiker	mosambiklaš

mot bedre vitende	báres diehtámuša vuostá

motanke	vuosteguoddaleapmi

motbevis	vuosteduođaštus

motivuttalelse	cuohkkecealkámuš

motkrav	vuostegáibádus

motordel	mohtoroassi

motorsenter	mohtorguovddáš

motsette seg	vuosttaldit

munnspeil	njálbmespeajal

munntørrhet	njálbmegoikan

muntlig forhandling	njálmmálaš gieđahallamat

muntlig innlegg	sáhkavuorru

muntlighetsprinsippet	njálmmálašvuođaprinsihppa

myanmarer	myanmarlaš

myrmalmuttak	jeaggemálbmarokkahat

måkehus	skávhlečilla

måle- og rapporteringsmetode	mihtidan- ja almmuhanvuohki

måleregler	mihtidannjuolggadusat

mødding	duvdni

møtefravær	čoahkkinhealban

møteopplegg	čoahkkinortnet

møteprosedyre	čoahkkinčađahanvuohki

nabobyggverk	ránnjávisti

namibier	namibialaš

namsmann	bággobearri

namsmyndighet	bággobearri

naturminne	luonddumuitu

naturpåkjenning	luonddudávggut

nauruer	naurulaš

nausttuft	návstosadji

nautisk mil	mearramiila

nebbtang	duolbabasttat

nedbrytende	mollejeaddji

nedbørfelt	njuoskkadatguovlu

nederlender	nederlándalalaš, hollándalaš

nedgangstid	fuones áigi

nedlegge påstand	čuoččuhit

nedlegge veto	veto-cealkámuš

nedskrivning	árvonjeaidin

nedtegne	čállit

nedtegning	čállin

negative tilrop	cielaheapmi

negativt flertall	negatiiva eanetlohku

neger	čáhppes olmmoš

nepaler	nepallaš

nettklasse	neahttaluohkká

nettofaktura	nettorehket

nettometode	nettometoda

nettoutbytte	nettodienas

nettsky	neahttabalva

nettundervisning	fierbmeoahpahus, neahttaoahpahus

neverett	čorbmaláhka

nevne innledningsvis	álggus namuhit

nevner i brøk	cuovkanamma

nicaraguaner	nicaragualaš

nigerer	nigerlaš

nigerianer	nigerialaš

nikotinerstatning	nikotiidnabuhtadus, nikotiidnaduddi

nikotinerstatningsterapi	nikotiidnaduddendikšu

nivåadskilt trafikkplass	dásseearuhuvvon johtolatsadji

njalla	njalla

node	earročuolbma

nomadiserende reindrift	johtti boazodoallu

nomadisk livsform	johttidilli

nordkoreaner	davvikorealaš

normalsats	dábálaš mearri

normalt	dábálažžat

norrøn tid	dárogiela-islánddagiela áigi

norsk fot	norgalaš juolgi

norsk lager	dárogiela oahpponeavvut

norsk mann	dáčča

norsk tannvern	norgga bátneválbmu

norsk-arktisk torsk	dáža-árktalaš dorski

notatblokk	čállinbáhpárat

nucleær medisin	nukleára dálkun

nucleærmedisinsk laboratorie	nukleáradálkkaslaš laboratoriija

nullstille, tilbakestille	bidjat ruovttoluotta, máhcahit

nyrebelte	čielgedoalan

nyttesrett	ávkkástallanvuoigatvuohta

nyttiggjøre	ávkkuhuvvot

nyttiggjøre seg av	ávkki atnit

nyzealender	aotearoalaš, ođđaselándalaš

næringsbetraktning	ealáhusdárkon

næringsfattig jordsmonn	duvttahis eanan

næringsmiddelkontrollen	biebmodárkkástus

næringssalter	biepmussálttit

nærlesning	áicevaš lohkan

nærmeste	lagamuš

nærnettet	lagasfierpmádat

nærstående	lagašolmmoš

nærundervisning	lagasoahpahus

nærvær	čuovvun

nødbelysning	heahtečuovga

nødrett	heahteriekti

nødstilfelle	heahtedáhpáhus

nødstoppanordning	heahtebissehanráhkkanus

nødverge	heahtegádjun

nødvergerett	heahtegádjunriekti

nøkkelvidde	čoavddagalljodat

nøkkelvrider	čoavddabonjan

objektiv beregning	bealehis luoittuheapmi

objektivt vilkår	objektiiva eaktu

obstruksjon	árrin

oddetallspotens	leaskalohkopoteansa

odel	árbevuoigatvuohta

offensive midtbanespiller	guovddášnjunuščiekči

offentlig forsvarer	almmolaš bealušteaddji

offentlig institusjon	almmolaš ásahus

offentlig myndighet	almmolaš eiseváldi

offentlig påtale	almmolaš áššáskuhttin

offentligrett	almmusriekti

offerring	oaffarriekkis

offersted	bálvvosbáiki

offerstein	bálvvosgeađgi

offside	báittohat

okserein	varis

oksygenmangel	áibmovátni

oldtid	máttaráigi

oljekanne	oljogádnu

oljelekkasje	oljolahcin

omaner	omanlaš

omarbeidelse	rievdadusbargu

omberammelse	ođđasis áigádeapmi

omdanne	earáhuhttit

omgjøre	nuppástuhttit

omgjøring	nuppástuhttin

omgående	seammás

omplassere	sirdit

områdefredning	guovloráfáiduhttin

omsorgsovertakelse	fuolahussirdin

omtvistet	riidovuloš

omvendt bevisbyrde	jorgaluvvon duođaštusnoađđi

omverdenen	olgomáilbmi

opinion	álbmotoaivil

oppbremsing	goazaheapmi

oppdeling	juohkin

oppfrisking	ođasteapmi

oppfriskning	ođđasisgieđahallan

oppfyllingsfrist	deavdin mearreáigi

oppfølgingsarkiv	čuovvunarkiiva

oppfølgingsregister	čuovvunregisttar

oppfølgingstjenesten	čuovvolanbálvalus

oppføring	mearkkuš

opphevelse	loahpaheapmi
opphevelse	fámuhuhttin

oppholdsforbud	orostallangielddus
oppholdsforbud	fitnangielddus

opphør	loahpaheapmi

oppklare	čielggadit

oppklaring	čielggadeapmi
oppklaring	čilgen

opplysningsskilt	dieđihangalba

opplysningstiden	čuvgehusáigi

oppmålingsmerke	mihttomearka

oppmøte	boahtin

oppnevning	nammadeapmi

opprettholde forslag	doalahit evttohusa

opprinnelig kostnad	álgovuolgga gollu

opprinnelig verdi	álgovuolgga árvu

oppsamlingsgate	čoahkkanangáhtta

oppsamlingsveg	čoahkkananluodda

oppsettende	doaisttážii

oppskriving	árvolokten

oppslag	seaidnečála

oppslagsterm	njunuštearbma, ohcantearbma

oppstuving	bahkkašuvvan, bahkašuvvan

oppta bevis	vuostáiváldit duođáštusaid

opptre forsvarlig	láhttet dohkálaččat

opptre med ringer rundt seg	áitalastit

ordne alfabetisk	alfabehtadit

ordreproduksjon	diŋgonbuvttadus

ordreprodusent	diŋgonbuvttadeaddji

oreigningslov	bággolonistanláhka

organisert fangst	searvebivdu

orienteringsfigur	čujuhangovus

orienteringshemmet	dádjatkeahtes

orienteringshemning	dádjadanváttisvuohta

orienteringsmøte	diehtojuohkinčoahkkin

overaktiv blære	guččahahkes ráhkku, goččahahkes ráhkku

overbegrep, overordnet begrep	badjedoaba

overbygd	sisahuksejuvvon

overdra	daguhit
overdra	doppidit

overflødig	dárbbašmeahttun

overgangsbestemmelser	gaskaboddasaš njuolggadusat

overgi	luohpadit

overheadprosjektor	čájehanmášiidna

overherredømme	bajimusmearridanváldi

overkommando	bajitkommando

overlagt drap	ulbmillaš goddin

overlastsikring	badjelguorbmesihkkarastin

overlegg	ulbmillaččat
overlegg	ulbmillaš

overløp	badjelšávahat

overløpsinkontinens, overflowinkontinens	govdaninkontineansa

overmettet marked	bakkagan márkanat

overoppsynsmann	bajimusbearráigeahčči

overordnet betydning	váldomávssolašvuohta

overordnet stilling	njunuš virgi

overprøvingsinstans	dárkodaninstánsa

oversiktsinformasjon	diehtočielggadus

overskjønnsrett	bajitárvvoštanriekti

overskuddsdisponering	badjebázahálden

overskuddsvirke	badjebázaávnnas

overstemme	báhcit unnit jienastagaiguin

overstige	mannat badjel

oversvømmelse	dulvi
oversvømmelse	čáhcešávva

overta	váldit badjelasas

overtenning	šloavván

overveie	árvvoštallat

overveiende	dettolaš

overvære	čuovvut

overøvrighet	badjebajit eiseváldi

ovnslokalitet	ommansadji

ozonnedbrytende stoffer	ozonloakti ávdnasat

pakistaner	pakistanlaš

palauer	palaulaš

palsmyrer	balsajeaggi

panamaner	panamalaš

panda	pandá

pantekrav	pántagáibádus

pantelov	pántaláhka

pantsettelse	pánta

papuaner	papuaođđaguinealaš, papualaš

paraguayaner	paraguaylaš

parallellparkering	bálddalas orusteapmi

parallellveg	bálddalas luodda

parallelt grensesnitt	buohtalaslakta

paranoia	paranoia

parkering	vuojánguođáhat

parkering forbudt	orustangieldu

parkering i to nivå	guovtti dási orusteapmi

parkeringshus i flere etasjer	máŋggagearddat biilaorustanviessu

parkeringsluke	orustangaska

parkeringslys	orustančuovga

partitiv begrepsrelasjon, del-helhet-relasjon;	partitiv begrepsrelasjon, del-helhet-relasjon;	+?

partsforhandling	oasehasdivaštallan

partsforhold	oasehasaid gorri

partsforklaring	oasehasčilgehus

partshjelp	oasehasveahkki

partshjelper	oasehasveahkki

partsoffentlighet	osolaččaid almmolašvuohta

partsoffentlighetsprinsippet	osolašalmmolašvuođaprinsihppa

partstilknytning	oasehasgullevašvuohta

pasientrettighetsloven	divššohasvuoigatvuođaláhka

passe seg	váruhit

passende	muttágis

passivt språk	passiiva giella

patologisk overspising	vuohppunváddu

pedagogisk konsulent	pedagogalaš oaivadeaddji

pedagogisk leder	pedagogalaš jođiheaddji

pedagogisk plattform	pedagogalaš vuođđu

pedagogisk/psykologisk testrom	pedagogalaš/psykalaš iskkadanlatnja

peileutstyr	čuovvunneavvu

peler	cakkit

pendel	dearbastihkka

pengeavsetning	bazahanruhta

periferipunkt	gierdočuokkis

periodens tilvirkningskost	áigodaga buvttadusgollu

perioderegnskapet	áigodatrehketdoallu

periodisering	áigodahttin

perleugle	bearalskuolfi

personalinngang	bargiid uksa

personaltoalett	bargiid hivsset

personlig forutsetning	persovnnalaš eaktu

personlig søksmål	persovnnalaš čuoččaldat

personopplysning	persondiehtu

personundersøkelse	olbmoiskan

personundersøker	olbmoiskkadeaddji
personundersøker	olbmodiđošteaddji

peruaner	perulaš

pinnefres	sággejurssan

pinolspiss	guovddášnjunni

planbord	duolbabeavdi

planert	dulbejuvvon

plangeometri	duolbadasgeometriija

planskive	duolbaskearru

plantemargarin	dipmamargariidna

plantestanol	šaddostanola

plantesterol	šaddosterola

plaskregn	arvešoaladat

plasseddel fra amtet	ámtta báikeduođaštus

plastisk bearbeiding	plástalaš gieđahallan

pleie- og omsorgsjef	dikšun- ja fuolahanhoavda

plenarbeslutning	dievasčoahkkinmearrádus

pliktig frammøte	čoahkkingeatnegasvuohta

polakk	polskalaš

polarmåke	stuorraskávli

polarstjernen	boahenávli

polemisk	riidobohciideaddji

politiarrest	polesareasta
politiarrest	butká

politiattest	polesduođaštus

politiavhør	bolesgažadeapmi

politiets sikkerhetstjeneste	bolesa sihkarvuođabálvalus

politiforklaring	polesčilgehus

politikammer	poleskámmir

politimyndighet	boleseiseváldi

politireserve	liigeboles

politivedtekter	ortnetnjuolggadusat

polysemi	polysemiija

portugiser	portugallaš

positionsret	árbevirolaš vuoigatvuohta

positive tilrop	doarjjačuorvvus

postfletting	boastabárgideapmi

postoperatør	poastaásahus

preakseptert	ovdagihtii dohkkehuvvon

prejudisiell	prejudisiála

presentasjonsmåte	ovdanbuktinvuohki

prestebolsgods	báhpaeanaopmodat

pretensjonskrav	čuoččuhusgáibádus

prinsipal	álgovurrosaš

prinsipal påstand	álgovurrosaš čuoččuhus

prinsipalt	álgovurrosaččat

printerinnstilling	čálánmearrádus

privat forsvarer	iežas háhkan bealušteaddji

privat gravsted	priváhta hávdesadji

privat straffesak	priváhta ráŋggástusášši

privet	čázehis hivsset

produksjonsfugl	čivganloddi

produksjonsleder	buvttadeaddji

produksjonslokale	buvttadanlatnja

produksjonsmåte	buvttadanláhki

produksjonsserie	buvttadangurgadas

produkter til byggverk	vistebuktagat

produktinformasjon	sisdoallučilgehus, buvttačilgehus

programmere	programmeret

proporsjon, forholdstall	gorri

proporsjonalitet	gorálašvuohta

proprium, egennavn	namma

prosessdyktig	proseassanávccalaš

prosessdyktighet	proseassanákca

prosessfullmakt	proseassafápmudus

prosessfullmektig	ášševálddálaš

prosesshandling	proseassadoaibma

prosesskrift	proseassačála

prosesskriftutveksling	proseassačálalonohallan

prosesskriv	proseassačálus

prosessledende	proseassajođiheaddji

prosessledende kjennelse	proseassastivrenmearrádus

prosessmateriale	proseassavuođđu

prosessor	doaimmár

prosessvarsel	proseassaalbmadeapmi

protokollasjon	beavdegirječállin
protokollasjon	čállin beavdegirjái

provisorisk	boddosaš

provokasjon	provokašuvdna
provokasjon	gohččun

prøvelsesrett	árvvoštallanváldi

prøveløslate	bidjat eaktovuloš friddjavuhtii

prøveløslatelse	eaktovuloš friddjavuohta
prøveløslatelse	geahččalanluoitin

prøvetid	geahččalanáigi

prøving	vuođustusiskan

psykisk funksjonshemmet	psyhkalaččat doaibmavádjit

psykisk helse	mielladearvvašvuohta

psykisk helsevernlov	mielladearvvašvuođadikšunláhka

psykisk utviklingshemmet	psyhkalaččat ovddádusvádjit

psykogeriatrisk avdeling	psykogeriatrija ossodat

publikumsbygning	álbmotvisti

publisert	almmuhuvvon, almmostahtton

pulverapparat	čáskadanbohtal

pumpestasjon	pumpastašuvdna
pumpestasjon	pumpastášuvdna
pumpestasjon	bumpenstašuvdna

punkt på dagsordenen	áššelistočuokkis

punktfeste	čuoggáláigu

punktsveiseapparat	čuokkissveisenapparáhta

punktsveising	čuokkissveisen

pynterom	čiŋahanlatnja

pythagoras læresetning	pythagorasa cealkka

pyttlav	láddojeagil

påanke	guoddalit

påberope	logahit
påberope	čujuhit

påbud	gohčus

påbudt rundkjøring	bákkolaš birravuodjin

pådra	dagahit

pådømme	dubmet

pådømmelse	duopmocealkin

påføre	dagahit

pågrepne	čogáduvvon

pågripe	váldit gitta

pågripelse	gittaváldin

påhvile	gullat

påkjære	váidit

påkrevd	dárbbašlaš

påkreve	gáibidit

pålegg om tilsvar	vástidangeasku

påligge	gullat

pålitelighet	luohtehahttivuohta

pålitelighetsklasse	luohttevašvuođajuohku

påregne	vuordit

påse	gozihit

påstandsendring	čuoččuhusnuppástuhttin

påstandsgrunnlag	čuoččuhusvuođđu

påstigningsareal	gorgŋenareála

påtalebegjæring	áššáskuhttingáibádus

påtalemakt	áššečuoččaldahttinváldi

påtalemyndighet	áššáskuhttineiseváldi

påtalerett	áššáskuhttinvuoigatvuohta
påtalerett	áššečuoččaldahttinriekti

påtalesubjekt	áššečuoččaldahttinsubjeakta

påtaleunnlatelse	áššáskuhttinheaitta

påtegning	čállin

påtenkt	jurddašuvvon

påtroppende formann	álgi ovdaolmmoš

qatarer	qatarlaš

radialboremaskin	radiálabovrenmašiidna

radialdekk	radiáladeahkka

radiallager	radiálaláger

radialveg	radiálaluodda

radiell	suonjardasti

radius	rádius

randbemerkning	ravdamearkkašupmi

ransake	burgit

ransaking	burgin

reaksjonstid	reakšuvdnaáigi

realbevis	áđalaš duođaštus

realisert avanse	duohtaobbadienas

realitetsavgjørelse	duođaid mearrádus

realregistrert	áđalaš registtar

realsikkerhet	áđalaš sihkkarvuohta

redaksjonslokale	doaimmahuslatnja

redegjøre	čilget

redningsmannskap	gáddjut

redskapsfortøyning	bivddusgiddestat

reell vekst	duohta árvobadjáneapmi

reelt bevismiddel	reála duođáštusgaskaoapmi

referatforbud	referáhtagielddus

refselse	huvden

regelkonflikt	regelgižžu

registerkjede	registtarviđji

registerreim	registtarruopma

regneart	rehkenastinvuohki

regnerekkefølge	rehkenastinortnet

regresskrav	regreassagáibádus

rehabilitering, avgiftning	eaidadandikšu

rein m/ bare ett horn	ápmil

reinbeitearealer	duovdagat

reindriftsregion	boazodoalloguovlu

reindriftsstruktur	boazodoallohámádat

reinsimle	áldu

reise sak	vuolggahit ášši
reise sak	čuoččaldahttit ášši

reise tiltale	áššáskuhttit

reklamasjonsnemnd	moaittalávdegoddi

rekvireringslov	bearranláhka

rekvireringsregel	bearrannjuolggadus

rengjøring	buhtisteapmi

renhold	buhtisteapmi

rennäringslag	boazodoalloláhka

renovasjon	ođasteapmi
renovasjon	doapparčorgen
renovasjon	čorgen, buhtisindoallan, doapparčorgen

renovation	buorideapmi

rensepunkt	buhtistansadji

rent flertall	čielga eanetlohku

replisere	dadjalit

repos	askki, stealli

reproduktiv helse	eatnánandearvvašvuohta

residere	ássat

resiprok	jorggu lohku

resirkulering	ođđasit ávkkuheapmi

ressursverdi	ávnnasárvu

restbeføyelse	báhcánráđđejupmi

restrett	báhcánvuoigatvuohta

restriktive tiltak	restriktiiva doaimmat

resultatgrad	boađusgráda

resultatkolonne	boađusčuolda

resultatlikhet	boađusovttaláganvuohta

resultatliste	boađuslistu

resultatløse forhandlinger	čoavddekeahtes šiehtadallamat

resultatorientert	boađusáŋgiruššan

resultatregnskapet	boađusrehketdoallu

retningsnummer	guovlonummar

rettarbot	diggesáhkku

rettergangsfeil	lágastanmeaddádus

rettergangsmåte	riektemeannudanvuohki
rettergangsmåte	lágastanvuohki

rettergangsskritt	lágastandahku

rettergangsstraff	lágastanráŋggáštus

rettersted	steavlidanbáiki

rettighetstap	vuoigatvuohtamassin
rettighetstap	vuoigatvuođamassin

retting	divvun

rettløpende lyn	bajánnjuolla

rettsanmodning	riektebivdda

rettsbelæring	riektečilgehus

rettsbok	riektegirji

rettsferie	riekteluopmu

rettsforfølgelse	šaddat rievtti ovdii

rettsforhandlinger	riektegieđahallamat

rettsforlik	riektesoabat

rettsformann	dikki ovdaolmmoš

rettsfølge	riektečuovvumuš

rettsgebyrlov	diggemáksoláhka

rettshandelsevne	doaibmanvuoigatvuohta

rettshandling	riektedoaibma

rettshjelper	riekteveahkki

rettshjelplov	riekteveahkkeláhka

rettshjelpsvirksomhet	riekteveahkkedoaibma

rettskraft	riektevuoibmi

rettskraftig	riektevuoimmalaš
rettskraftig	riektevuoimmálaš dg

rettskrets	riektebiire

rettslig avgjørelse	riektemearrádus

rettslig inkasso	rievttálaš vealgebearran

rettslig medhjelper	lágastanveahkki

rettsmedisinsk	riektemedisiinnalaš

rettsmekler	diggesoabahalli

rettsmekling	diggesoabahallan

rettsmeklingsprotokoll	diggesoabahallanbeavdegirji

rettsmiddelfrist	riekteneavvomearreáigi

rettsråd	láhkaveahkki

rettssikkerhetsprinsipp	riektesihkkarvuođaprinsihppa

rettsvinning	riektevuoitu

rettsvitne	diggevihtan

revle	revlet

riksadvokatembete	riikaadvokáhttaámmát

rile	báhkki

rimelig tvil	govttolaš eahpádus

rimelighetsvurdering	govttolašvuođa árvvoštallan

ringformet tunanlegg	rieggáhápmásaš šilljoráhkadus

ristning	sárggus

rohopute	rohoguoddá

rokke ved	doadjit

rom for heis	vintalatnja

romgeometri	latnjageometriija

rorbu	guolástanviessu

roterende senterspiss	jorri guovddášnjunni

rotfylling	bátnedeavdda

rotoverflate	bátnemáddaga olggoš

rotsement	bátnemáttasemeanta

rugde	vuovdemeahkástat

rulle, scrolle	rullet

rullende fortau	jorri vázzinravda

rumener	románialaš, romanialaš

runeinnskrift	runasárgun

rusmiddelavhengighet	gárrenmirkoaddikšuvdna

russekors	ortodoksa ruossa

rutegående	ruvttojohtti

rutenett	ruktoneahtta, ruvttodat

rutetrafikk	áigemeari johtolat

rwander	rwandalaš

rydningsmenn	ođđaássi

rygg på øks	ákšošimir

ryggstøtte	čielgestielgu

råbalanse	álgodássádat

rådføre	ráđđádallat

rådføre seg med	ráđđádallat

rådighetsbegrensning	ráđđenráddjen

rådighetsrett	ráđđenriekti

rådslaging	ráđđádallan

råjern	álgguviđá ruovdi

råutkast	álgoevttohus

rødmoldstue	ruksesjeaggemuoldobovdna

rødvingetrost	ruksessoadjá

rødåte	boggi

rømning	báhtareapmi

rømning av personer	olbmuid gádjun

rørarmatur	bohcceoassi

rørkutter	bohccečuohpan

rørlegger	bohccebargi

røropplegg	bohccehoidu

rørsplint	bohccesággi

rørtang	bohccebasttat

røsteplass	jeaggemálbmaboalddáhat

røykgasskondensering	suovvagássakondenseren
røykgasskondensering	suovvagássakondenseren, suovvagássačáhcun

røykproduksjon	suovasteapmi

røykstue	suovvavisti

røys	borra

røysfelt	borrabáiki

sabotasje	sabotáša

sabotasjehensikt	sabotášaáigga

sabotere	saboteret

safe	dorvovuorká

sakarkiv	áššearkiiva

sakens art	ášši luondu

sakkyndigbevis	dovdiduođaštus

sakkyndiges erklæring	áššedovdi čielggadus

sakkyndiges forklaring	áššedovdi čilgehus

sakkyndighet	dovdan

saksavvikling	áššečađaheapmi

saksforberedelser	áššeráhkkaneapmi

saksforberedende møte	ráhkkanančoahkkin

saksforbereder	ášševálmmasteaddji

saksframstilling	áššegovvideapmi

sakskostnader	áššegolut

sakskostnadsansvar	áššegolloovddasvástádus

sakskostnadsoppgave	áššegollodieđáhus

saksstyrende	áššestivrejeaddji

saksøkte	ášši vástideaddji

saldo	saldo

saldoavskrivning	saldovuolidahttin

saldobalanse	saldodásádat

saldometode	saldovuohki

salgsrepresentant	vuovdaleaddji

salomoner	salomonsuolohas

saltvannoppløsning	sáltečáhci

salvadoraner	elsalvadorlaš

samisk skinnbukse	sisttehat

samkvem	oktavuohta

samlede	buohkanas

samlerstadium	čohkkendássi

samlingsstyrer	čoakkáldatgoziheaddji

samlivsbrudd	earráneapmi

sammenbrudd	doddjon
sammenbrudd	gahččan
sammenbrudd	boatkaneapmi

sammenkomst, møte	čoahkkin

sammenpakket snø	ceavvi

sammensatt term	goallostearbma

sammenstilling	čoahkkáigeassu

sammenstøt	oktiinordadeapmi

samoaner	samoalaš

samordningsoppgave	bálddalastinbargu

samsvarsvurdering	ovttavásttolašvuođa árvvoštallan

samtykkekompetanse	miehtangealbu

sandlo	buvvedat

sangsvale	njukča

sanitære forhold	buhtisvuohta

sanitærrom	buhtisvuođalatnja

sanktkitter	saintkittslaš, saintkittsnevislaš

sanktlusianer	saintlucialaš

sanktvinsenter	saintvincentgrenadiinnalaš, saintvincentlaš

sanmariner	sanmarinolaš

sannferdig	vuoiga

sannhetsbevis	duohtavuohtaduođaštus

sannhetsplikt	vuoigasárdnun geatni

sannsynliggjøring	jáhkehahttin

saotomeser	saotomepríncipelaš, saotomelaš

saudier, saudiaraber	saudiarabialaš, saudiaarába

sedelighet	šiehku

sedelighetsforbrytelse	rohcošanvearredahku

sedvanerett	dološ vieruiduvvanriekti

seihval	sáidefális

seilingsmerke	borjjastanmearka

seilsperring	borjjastaneastta

sekretmobilisering	šliivvi luvven

seksualforbrytelse	rohcošeapmi

seksuell omgang	seksuála ovttastallan

seksuelt overførbar sykdom	seksuálaččat njoammudávda

selen	selena

selvaktelse	iešárvu

selvforskyldt rus	iešdagolaš gárrenvuohta

selvmotsigende	iešvuosttaldeaddji

selvstarter	čoavddavuolggahus

selvstendig næringsdrivende	iehčanas ealáhusdoalli

sende pasning, slå pasning	sáddet

senegaleser	senegallaš

sengebelte	seaŋgaboagán

sengebu	seaŋgavisti

sengeforhøyningskloss	seaŋgaaládus

senior	báris ahkásaš

seniorklasse	báris ahkásaččaid luohkká

senterbor	guovddášbovra

senterhøyde	guovddášallodat

sentralafrikaner	gaskaafrihkálaš

sentralt motorvognregister	mohtorfievrruid registtaguovddáš

sentrifuge	čáhcenjaman

sentrumsparkering	guovddášorusteapmi

sentrumsvinkel	guovddášviŋkil

servicestasjon for biler	biilafuolahat

sesongflytting	áigodatjohtolat

sesongmessig bruk	áigodatgeavaheapmi

sesongmigrasjon	áigodatsirddolašvuohta

seterbruk	geassesajdoallu

sette møte	álggahit čoahkkima

sette opp stolpene i et laksestengsel	čuldet

sette til auksjon	bidjat bidjegii

seycheller	seychellalaš

sfærisk lager	sfearálaš láger

sidefløy	viessosoadji

sideforskyvning	ravdalas

sidekant	siidoravda

sidemarg	siidoravda

sidemuskel	erttetdeahkki

sideoppsett	siidohápmi

sideordnet	bálddalas

sideordnet begrep, sidebegrep	buohtalasdoaba, bálddalasdoaba, bálddadoaba

sideutgift	oalgegollu

sieidi	sieidi

sierraleoner	sierraleonelaš

sik, stor sik	čálat

sikkerhet i bruk	geavahussihkkarvuohta, geavahansihkkarvuohta

sikkerhetslager	dorvorádju

sikkerhetslov	sihkarvuođaláhka

sikling	liktenstálli, likti

sikre bevis	sihkkarastit duođaštusaid

sikringssone	váfistanavádat

siktet	áššáiduhtton

siland	smávvagoalsi

sile en anke	sillet guoddaleami

simpelt flertall	álkis eanetlohku

simpelt tyveri	dábálaš suoladeapmi

simulere	dahkaluddat

simultantolking	simultána dulkon

singaporer	singaporelaš

sinnslidelse	miellaváddu

sinnslidende	miellabuohcci

sinnstilstand	mielladilli

sirkeldefinisjon	jorusdefinišuvdna, jorusmeroštallan

sivil person	siviilaolmmoš

sivil sak	siviila ášši

sivil ulydighet	siviilajeagohisvuohta

sivilist	siviila

sivsanger	goalšoruoššehas

sjakt	šákta

sjalterom	šáltenlatnja

sjelesørger	vuoiŋŋalaš láidesteaddji

sjenerende	giksašuhtti

sjøfartsbok	mearrajohtingirji

sjøhus	mearravisti

sjøleiende	iešeaiggát

sjølov	mearraláhka

sjømerke	mearrajohtolatmearka

sjøorre	skoarra

sjøpølse	bodneluomi

skade på liv	heaggaroasmmoheapmi

skadelidende	vahágahtton

skadelidt	vahágahtton
skadelidt	vaháguvvan

skaderisiko	vahátriska

skadeserstatning	vahátbuhtadus

skadevolder	vahágahtti

skanse	suodjalusmuvra

skarpsyn	čielgaoaidnu

skifte til fjernlys	molsut guhkes čuvgii

skifte til nærlys	molsut oanehis čuvgii

skifteloven	juohkoláhka

skiftesamling	juohkočoahkkin

skikket	dohkálaš

skillekonstruksjon	earuhanráhkadus

skilsmissebo	earrooapmi

skinnegang	ruovdemáđii

skipsdel	skiipaoassi

skipsfunn	skiipagávnnus

skipslast	skiipaguorbmi

skittentøy	duolvagávnnit

skivebrems	šiivagoazan

skivehjul	šiivajuvla

skjellig	govttolaš

skjermforklaring	šearbmačilgehus

skjerp	málbmarokkahat

skjerpe straffen	čavget ráŋggáštusa

skjerpende	čavgejeaddji

skjult	čiegus

skjærehastighet	čuohppanleaktu

skjærekant	bátneravda

skjæring	russen

skjønnhetshensyn	čábbodatvuhtiiváldin

skjønnlitterær forfatter	čáppagirjjálašvuođa čálli

skjønnsmessig	muttolaš

skjønnsmessig avveing	muttolaš vihkkedallan

skjønnsmessig vurdering	muttolaš árvvoštallan

skjønnsprosesslov	árvvoštallanproseassaláhka

skjøtsel	dikšu

skli underlag	coakcunvuloš

sklisikre remser	coakcilvuođa ráiddut

skrapevogn	ráhpunfievru

skreisesong	áhpedorskeáigodat

skriftlig behandling	čálalaš gieđahallan

skriftlig innlegg	čálavuorru

skriftlig materiale	čálalaš duođáštus

skriftlig votering	čálalaš jienasteapmi

skriftprosjektor	čálačájeaheaddji

skrive- og arkivleder	čállin- ja arkiivvajođiheaddji

skrivesentral	čállinguovddáš

skruedrev	bonjisjuvla

skråp	šleanzi

skyldfri	sivaheapme

skyldner	velggolaš

skyldspørsmål	sivalašvuođagažaldat

skyllemiddel	doiddas

skyte ut	čuoldit

skytterstilling	báhčinsadji ja –rusttegat

skålgrop	geađgegobáš

skålgropfelt	geađgegohpebáiki

skålgropstein	gohpegeađgi

skånsom	olmmošlaš
skånsom	láđđásit

slagboremaskin	časkinbovrenmašiidna

slagg	buollángarra

slaggforekomst	málbmasuddosat

slagghammer	bázahasveažir

slaglengde	časkinguhkkodat

slagseighet	časkindávgadat

slakteplass	njuovadansadji
slakteplass	ávttadat

slange	šláŋŋa

slangeklemme	šláŋŋačárvvon

slegge	šleagga

slektning i rett oppstigende linje	njuolggo máddofuolki

slimhinne	šliiveassi

slipekorn	šliipengordni

slipelerret	šliipenliidni

slipelære	šliipenmálle

slipemiddel	geallanávnnas

slipeskive	šliipenskearru

slipestift	šliipennibba

slipp	skiipadealádat

slokkemannskap	čáskadeaddjit

slovak	slovakialaš

slovener	slovenialaš

sluseventil	buođđoventiila

sluttbehandling	loahppameannudeapmi

sluttbemerkning	loahppamearkkašupmi

sluttforedrag	loahppačilgehus

sløyd fisk	čollojuvvon guolli

sløye mye, sløye fort	čoalluladdat

smak til potet	buđetbáidna

smertevoldende	bávččagahtti

smieplass	rávdebádji

smihammer	bádjeveažir

smitang	bádjebasttat

smittevern	njoammudávddaid eastadeapmi

smittevernloven	njoammudávddaid eastadanláhka

smusstillegg	durdelasáhus

småbarnsmor	eadni

småbrukerlaget	smávvadáluidsearvi

småhyse	diksumurtu

småkravprosess	gáibádusažiidproseassa

småuer	čunugoallár

snarest	farggamusat

snekkeskrue	bonjisskruvva

snespurv	állat

sniffing	gárrensustin

snittebønne	duolbabáhpu

solar	dieselolju

solcelle	beaivvášsealla

solfaktor	beaivvášdagaldat

solidaransvar	ovddasvástolaš ovddasvástádus

solur	beaivvášdiibmu

som er på god vei til å være hedning	báhkinlágáš

somalier	somalialaš

soneforsvar	avádat caggan

soning	gednen

sosialt nettverk	dorvofierpmádat

sosialt omdømme	nammagulustuvvan

sosialtjenesteloven	sosiálabálvalusláhka

sparebanklov	seastinbáŋkoláhka

spatt	báhtte

spennbakke	čavgenoalul

spennblikk	čavgenspelle

spennhylse	čavgenskuohppu

sperre	buođđut

sperre av	giddet

sperregjerde	oahceáidi
sperregjerde	áidi

spesialiseringsgrad	sierradássi

spesialisthelsetjenesteloven	spesialistadearvvašvuođabálvalusláhka

spesiallovgivning	sierralágat

spesialpedagog	spesiálpedagoga

spesialprosess	sierraproseassa

spesialundersøkelse	sierraiskan

spesialveg	erenoamaš luodda

spillvannsledning	duolvačáhcebohcci, durdečáhcebohcci
spillvannsledning	durdečáhcebohcci

spiralbor	bonjisbovra

spiralspor	bonjisgurra

sponhøvel	vuollanheavval, vuolahasheavval

spordstykke på fisk	beahcetčaskkis

sporing	guorran

springflo	čeavanolle

sprinklersentral	cirgganguovddáš

sprøytenål	čuggestatnállu

spurvehauk	dihtti

spylespiss	cirgganjunni

spyttproduksjon	čolgabuvttadus

spørring	jearran

spørsmålsskrift	gažaldatčála

srilanker	srilankalaš

stabla	čobmejuvvon

stadfestelse	nannejupmi

stake avsted, stake litt	čuoibmulit

stake, holde på med å	čuoibmuladdat

stakepunkt	čuoggunsadji

stakktuft	stáhkkásadji

standardformat	standárdasturrodat

standardisering	standárdiseren

standardklasse	standárdaluohkká

standardskuter	standárdaskohter

standardspill	dábálaš speallu

standardverktøy	standárdaneavvu

standplass	čuožžunbáiki

standpunkt	oaivil

stang ved stranden	álli

stansing	orustahttin

starttrafikk	álgi johtolat

statuslinje	stáhtuslinnjá

stavkirke	skielttargirku

sted på fiskegarn/ not hvor det er bøtt	čivttadat

stedfortredende	sadjásaš

stedlig	sajálaš

stedlig domsmyndighet	báikkálaš dubmenváldi

steforelder	eadnebealli
steforelder	áhččebealli

steinband	buddobáddi

steinbu	geađgeskadjá

steinkors	geađgeruossa

steinkrets	geađgeriekkis

steinplatting	geađgelávdi

steinskvett	rásttáš

steinstreng	geađgeáidebázahusat

steinsøkke	buddu

stell	čahpan

stemmeflertall	jienastateanetlohku

stenograf	stenográfa

stenografere	stenográfet

stevnes	stevdnehallat

stevnevitne	stevdnenvihtan

stift	bismaguovlu

stigende linje	badjáneaddji linnjá

stigningsgrad	ceggodat

stikke av	čugget

stikkstål	čuggenstálli

stingsild	bišáhke

stolpehull	čuoldasadji

stor flat stein	átnu

storjo	stuorraskáiti

stormaktstid	stuorrafápmoáigi

storvrenge	duolbajeagil

straffalternativ	ráŋggáštusmolssaeaktu

straffansvar	ráŋggáštusvástu

straffbart lovbrudd	ráŋggáštahtti láhkarihkkun

straffebud	ráŋggáštusmerren

straffedom	ráŋggáštusduopmu

straffegjennomføring	ráŋggáštusčađaheapmi

straffegjennomføringslov	ráŋggáštusčađahanláhka

straffekrav	ráŋggáštusgáibádus

straffeloven	ráŋggáštusláhka

straffeprosessloven	ráŋggáštusproseassaláhka

strafferamme	ráŋggáštusrádjá

strafferegisteret	ráŋggáštuslogahallan

strafferettspleie	ráŋggáštanriektedoallu

straffeskjerpelse	ráŋggáštusa čavgen

straffeskjerpende omstendighet	čavgejeaddji dilli

straffeskyld	ráŋggáštussivva

straffespørsmål	ráŋggáštusgažaldat

straffnedsettende	ráŋggáštusvuolideaddji

strafforfølgning	ráŋggáštusčuovvoleapmi

straffri	ráŋggáškeahttá

straffutmåling	ráŋggáštusmihtideapmi

strandsnegl	bussáskálžu

strandvollgrav	riddohávdi

strengeste	garraseamos

strengeste straff	garrasamos ráŋggáštus

stressreaksjon	huššareakšuvdna

stridende	russolas

strupeventil	buvihanventiila

stupetårn	buokčalandoardna

styrketreningsapparatur	áhpasmahttinráhkkanus

ståbenk	čuožžunbeaŋka

stående kvist	ceakko rissi

stående mappe	ceakkomáhppa

ståseng	čuožžunseaŋga

ståstativ	čuožžunveahkki

stær	stárra

støpsel	el-culci

støpt	leikejuvvon

støpul	biellodoardna

størrelsesangivelse	sturrodatalbmadeapmi

støtdemper	dustton

støte og bli hengende fast	čuohcit

støtende	čuohcci

støttereaksjon	dorjenreakšuvdna

støyplage	šlápmagiksi
støyplage	šlápmagiksi, riedjagiksi

støyvern	riedjasuodjalus, šlápmasuodjalus
støyvern	šlápmasuodjalus

subjektiv kriterium	bealálaš eaktu

subjektiv skjønn	bealálaš árvvoštallan

subjektiv skyld	subjektiiva sivalašvuohta

subjektivt vilkår	subjektiiva eaktu

subsidiær fengselsstraff	maŋitvurrosaš giddagasráŋggáštus.

subsidiær påstand	maŋitvurrosaš čuoččuhus

subsidiært	maŋitvurrosaččat

subsumere	subsumeret

subsumsjon	subsumšuvdna

subtraktiv tospråklighet	subtraktiiva guovttegielatvuohta

sudaner	sudanlaš

suffli	cavgileapmi

sufflør	cavgileaddji

sukrose, sakkarose	sakkarosa, sukrosa

sunnhet	dearvvašvuohta

superlim	goikilisliibma

supplerende	deavdda

supplering	lasiheapmi

surinamer	surinamelaš

suverenitetskrav	bajimusmearridangáibádus

svampelegeme	báddanoažži

svarthvit fluesnapper	girjelivkkár

svartspett	ruovddagas

sveiseapparat	sveisenapparáhta

sveisebend	sveisenmoalki

sveiseblink	sveisensuddon

sveisebrenner	sveisenboalddán

sveiseelektrode	sveisenelektroda

sveisefuge	sveisenluodda

sveisemaske	sveisenhápma

sveisestreng	sveisensuotna

sveisetråd	sveisenárpu

sveising	sveisen

sveitser	sveicalaš

svingpil	mohkastannjuolla

swazilender	swazieatnanlaš

sykepleiefaglig	buohccedivššárfágalaš

sylinderblokk	mohtorgorut

sylinderlekkasjetester	sylinddarsuođđaniskan

symfyse	cahcanjuorggis

synes synd i	árkkášit

synkende linje	njieddji linnjá

synkroniser	synkroniseret

synonymi	synonymiija

synsing	doaivun

syrer	syrialaš

sysselsettingsfaktor	bargosuorgi

systematisk oppstilling	systemáhtalaš ortnet

såerle	fiskesbeštor

sårpasta	hávvevuoiddas

særegen	erenoamáš

særeiegrunn	sierraeaiggáteana

særfordel	sierra ovdamunni

særlig tilfelle	sierradilli

særreaksjon	sierračuovvumuš

særspørsmål	sierragažaldat

særtrekk	dovddamearka

særvilkår	sierraeaktu

søkmålsadgang	áššečuoččaldahttinvejolašvuohta

søknadspliktig	ohcangeatnegas

søksmål	ášši vuolggaheapmi

søksmålfrist	ášši vuolggahanáigi

sølvtape	silbateaipa

sønn og far	áhčežagat

sør-afrikaner	lulliafrihkálaš, máttaafrihkálaš

sørkoreaner	lullikorealaš, máttakorealaš

sørsudaner	máttasudanlaš, lullisudanlaš

søst	cohkodat

søtningsmiddel	goanstasohkar

søyleboremaskin	čuoldabovrenmašiidna

ta sild med håv	rumppa roggat

ta til etterretning	diehtun váldit

ta tilbake	geassit

tabulator	tabuláhtor

tadsjiker	tažikistanlaš

tagglav	bihkkajeagil

takflate	rohpeviidodat, dáhkkeduolbbaš, dáhkkeviidodat, rohpeduolbbaš

takoverdekning	olgorohpegeahči

takterrasse	rohpeterássa

takutspring	rohpegeaigán

tallenhet	lohkoovttadat

tangentvinkel	tangeantačiehka

tankbil	dáŋkabiila

tannhelsekontroll	bátnedárkkisteapmi

tannkjøttbetennelse, gingivitt	algŋavuolši, aldnavuolši

tannkjøttkant	aldnaravda, algŋaravda

tannpleietjeneste	bátnedikšunbálvalus

tannstang	bátnestággu

tanzanianer	tanzanialaš

tape en sak	vuoittahallat áššis

tappested	luoitinsadji, golggahansadji

tarebakke	šleanzebáhkka

tarmer	čoalit

tarmgrønske	šliivi

tarv	fuolla

taurin	tauriidna

taushetsbelagt	jávohisvuođageatnegasvuođa vuollásaš

tauskiverom	báddeskearrolatnja

teglovn	diilaomman

teknisk bygning	teknihkalaš visti

tekniske spesifikasjon	teknihkalaš dárkkustus
tekniske spesifikasjon	teknalaš dárkkistus, teknihkalaš dárkkistus

tekstilforming	dipmaduodji

tekstskilt	čálusgalba

telefonkiosk	telefonkioska

tellende stemmer	dohkalaš jienat

teltboplass	lávvosadji

teltring	lávvosadji

temporal begrepsrelasjon, tidsrelasjon	áigegaskavuohta, temporála áigegaskavuohta

tenningsnøkkel	cahkkehančoavdda

tenningssystem	cahkkehanrusttet

tennplugg	cahkkehanginttal

termbank, terminologisk database, termbase	tearbmadiehtovuođđu, terminologalaš diehtovuođđu

termharmonisering	tearbmaharmoniseren

terminologi 1	terminologiija čoakkáldat

terminologilære, terminologi 2	terminologiijaoahppa

terminologisk konkordans	terminologalaš konkordánsa

terminologisk ordbok	terminologalaš sátnečoakkáldat

terminologisk uttrykk, terminologisk frase	terminologalaš gihppu, terminologalaš frása

terminologiske data	tearbmadieđut, terminologalaš diehtu

termpost	tearbmasajus, tearbmaboasta

termpostformat	tearbmaboastamálle

terrenggående barmarkskjøretøy	meahccebievlavuoján

terrenggående kjøretøy	meahccefievru

terrengnivå	eanadássi

tettbygd strøk	čoahkkebáiki

tettemelk	lohppehat

tetthet	divttisvuohta
tetthet	daškatvuohta

thailender	thaieatnanlaš

tidligere straffet	ovddežis dubmejuvvon

tidsavgrenset parkering	áigemeari orusteapmi

tidsspille	áigeheavvu

tiendel	logádas

tierpotenser	logipoteanssat

tilbakeholding	doaladeapmi

tilbakekall	máhcahangohččun

tilbakekalle	gohččut máhcahit

tilbakekalling	máhcahangohččun

tilbaketreden	geassádeapmi

tilbakevise	dusttodit

tilbyder	fálli

tilbørlig	govttolaš

tildeling	juolludeapmi

tilfalle	mannat

tilflyte	dábuhit

tilfredsstillende	dohkálaš
tilfredsstillende	soahppevaš

tilførsel	lasáhus

tilføyelse	lasáhus

tilgodehavende	vealgumuš

tilgrensende	lagas

tilintetgjøring	duššadeapmi

tilkomme	gullat

tillatt	lobálaš

tillatt term	dohkálaš tearbma

tillegg av tid	áigelasiheapmi

tillegge	bidjat

tilleggsavgjørelse	lassemearrádus

tilleggsdom	lasseduopmu

tilleggserklæring	lassecealkámuš

tilleggsstraff	lassiráŋggáštus

tilliggende	bálddas

tillitskapende	luohttámušluovvi

tillitsvotum	doarjjajienasteapmi

tilløp	bálkestanlávki

tilrettelagt	láhččojuvvon

tilrettelegging for drift	doaibmanláhčin, geavahanláhčin

tilrådet term, anbefalt term	ávžžuhuvvon tearbma, rávvejuvvon tearbma

tilsatt	virggehas

tilsi	bearihit

tilsmussing	durdun, dággun

tilsnakk	cuiggodeapmi

tilstedeværende	oassálasti

tilstedeværende, de	diggelatnjaolbmot

tilståelsesdom	dovddastusduopmu

tilsvar	vástta
tilsvar	vástádus

tilsvarsfrist	vástidanáigi

tilsynsmann	gohcci

tiltakskonsulent	doaibmaoaivadeaddji

tiltalebeslutning	áššáskuhttinmearrádus

tiltalepost	áššáskuhttinčuokkis

tiltales	áššáskuhttot

tiltalespørsmål	áššáskuhttingažaldat

tiltalte	áššáskuhtton

tiltre	álgit
tiltre	guorrasit

tiltrekkingsmoment	čavgenmomeanta

tiltrekningsavstand	lohkkadangaska

tinglyse	gulahit

tinglysningslov	diggelogahanláhka

tinglyst	gulahuvvon

tingsted	diggebáiki

titusenere	logiduháhat

tjenestegjøre	doaibmat

tjenestemottaker	bálvalusgeavaheaddji

tjenestepensjon	bargopenšuvdna

tjenesteyter	bálvalusfálli

tjenlighet	dohkálašvuohta

tjærebrenning i gryte	bihkkaboaldin báđis

tjærebrenningsanlegg	bihkkaboaldinrusttet

tjærehjell	bihkkaloapmi

tjæremile	bihkkahávdi

tjæremile i myr	bihkkahávdi jeakkis

tjærerenne	bihkkarenne

toalett - funksjonshemmede	doaibmavádjegiid hivsset

toalettforhøyer	hivssetalidahtti

tofeltsveg	guovttejuogu luodda

tofte	duoktu

togoleser	togolaš

toksin	toksiidna

tollbod	duollovisti

tollepinne	ákŋobealgi

tolloppsyn	duollogeahčču

tollov	tuolloláhka

tommestokk	máhccemihttu, lađasmihttu, máhcastatmihttu

tonganer	tongalaš

toppdykker	silkebuokča

torada lager	guovtteráiddoláger

tornsanger	miesttavizar

tort	vuorrástuhttin

torvskur	darfeloggun

torvtørkeplass	darfegoikadansadji

torvuttak	darfelokkohat

torx skrutrekker	torx-skruvvabonjan, torxskuvabonjan, torx-skruvvaruovdi

torx-skrue	torxskruva, torx-skruvva

totaktsmotor	guovttedávttatmohtor

tradisjonslokalitet	árbevierrobáiki

trafikk pr. time	diibmosaš johtolat

trafikkdata	gulahallandiehtu

trafikkforseelse	johtolatrihkkumuš

transfett	transvuodja

transmisjon	transmišuvdna

transmisjonsvarmetap	transmišuvdnaliekkassuođđan

transparens	njoađvi, njoađđi

transparent	čuovgaárka

trappeheis	tráhppafinta, tráhppahissa, tráhppavinta, tráhppaheaisa
trappeheis	tráhppavinta

travelhet	dilihisvuohta

travers	doaresbielká

tre i kraft	šaddat gustovažžan

tre tilbake	geassádit

tredjemann	oalgeolmmoš

tredjeperson	oalgeolmmoš

treffe en avgjørelse	mearridit

tregjerde	muorraáidi

trekkdyr	gisor

treløs slette	ádju

treningslokale	hárjehallanlatnja

trepiplerke	muorracivkkán

trifon	bássi hápma

trinidader	trinidadtobagolaš

trinnhøyde	bátnegaska, ceahkkegaska

trinnlyd	vázzinjietna

triviallitteratur	ájánasgirjjálašvuohta

truende atferd	balddihahtti láhtten

truser	čurtebuvssat

trygderetten	oadjoriekti

trykksak	preantagálvu

trådløst nettverk	áibmofierpmádat, áibmofierbmi

trålerloven	áhpenuohtástanláhka

tsjader	chadlaš

tungmetaller	lossametállat

tunisier	tunisialaš

tunnell	báktesisgeaidnu

turkmener	turkmenistanlaš

turnering	čiekčangilvaleamit

turutstyr	meahcástan biergasat

tuvaler	tuvalulaš

tvangsdekning	bággogokčan

tvangsfullbyrde	bákkuin ollašuhttit

tvangsfullbyrdelsesloven	bággoollašuhttinláhka

tvangsgrunnlag	bággovuođđu

tvangskraft	bággofápmu

tvangskraftig	bággofámolaš

tverregg	doaresávju

tverrfriksjon	doarrásruvven

tverrsleide	doaresmielggas

tvilstilfelle	eahpádussoaitin

tvistegjenstand	riidofáddá

tvisteloven	riidoláhka

tvisteløsningsnemnd	riidočoavdinlávdegoddi

tvistemålsloven	riidoláhka

tvistenemndsvedtak	riidolávdegoddemearrádus

tvistepunkt	riidočuolbma

tvistesum	riidosubmi

tvungen	bákkolaš

tvungent psykisk helsevern	bákkolaš mielladearvvašvuođadikšu

tyngende	lossa

tynne delen av øks	ákšodearri

tyvjo	suolaskáiti

tåkeklokke	mierkábiellu

tøffler	loabáhat

tømmerskot	dimbbarluoittáhat

tørkeplass	goikadanbáiki

tørkes	čuomastuvvat

tørt vindfall	goikan bieggagahčahas

uaktsom	ávvirmeahttun

uaktsomhet	ávvirmeahttunvuohta

uaktsomt drap	dáhtokeahtes goddin

uangripelig	láitemeahttun

uanstendig og grov munnbruk	njálmmušteapmi

ubestemt	mearritmeahttun

ubestemt mistanke	mearritmeahttun várohus

ubetenkelig	eahpidahtekeahttá

ubetinget dom	eavttohis duopmu

ubetinget fengsel	eavttuhis giddagas

ubetinget frihetsstraff	eavttohis friddjavuođaráŋggáštus

ubetydelig	mearkkašmeahttun

ubrennbart	buoliheapmi

ubundet	luovus

uegnet	heivemeahttun

uforbeholden forklaring	njuolggo čilgehus

uforbeholden tilståelse	eavttuhis dovddastus

uforholdsmessig	eahpegorálaš

uformuende	opmodaga haga

uforpliktende tilbud	čanakeahtes fálaldat

uforsvarlig	hárehis
uforsvarlig	bealušmeahttun

ufullstendighet	váilevašvuohta

ugander	ugandalaš

ugjerning	vearredahku

ugunst	eahpeoiddolaš

ugunstig	oidduhis

ugunstige	headju

ugyldighet	fámohisvuohta

uhelbredelig	buoritmeahttun

uinnredet	gárvviskeahtes

uklarhet	eahpečielggasvuohta

ukontrollert	dárkokeahtes

ukrainer	ukrainalaš

ulvestue	gumpebivdoroggi

ulydighetskampanje	doahttalkeahtesvuođa čájeheapmi

umiddelbar bevisføring	njuolggo duođaštallan

umiddelbarhetsprinsippet	njuolggoduođaštallanprinsihppa

umoden molte	čurro

umyndiggjøre	válddehuhttit

under den kriminelle lavalder	kriminála agivuloš

under terreng	eanadási vuolde

undergi	vuolládastit

undergitt	vuollásaš

underhold	ealiheapmi

underkaste	vuollástit

underlagt	vuollásaš

underlegge	vuollástit

underordnet	vuolit

underordnet begrep, underbegrep	vuolledoaba

underretning	dieđiheapmi

underrette	dieđihit

undersøkelseskommisjon	iskkadankommišuvdna

undertekst	čiegusoaivil

undervisningsanlegg	oahpahusrusttet

unndra	beasadit

unndra seg	beasadit

unnlate	garvit

unnlatelse	garvin

unnta	spiehkastit

unntakstilfelle	spiehkastat

unntatt fra	čuldojuvvon

uoppfordret	ihcalassii

uoversiktlig	seađas

upartisk	oasehis

upartiskhet	oasehisvuohta

upraktisk	eahpegeavatlaš

uprovosert	provoserekeahttá

upåkrevd	ii vealtameahttun

urinlekkasje	gožžaribaheapmi, gužžaribaheapmi

urnordisk	vuođđodárogiella

urpremiere	álgočájálmas

uruguayaner	uruguaylaš

usann	eahpeduohta

usann forklaring	eahpeduohta čilgehus

usannhet	eahpeduohtavuohta

usbeker	uzbekistanlaš

usedelighet	rohcošeapmi

uskikket	dohkkemeahttun

utagerende atferd	bieđđat dohkketmeahttumit

utdata	dihtorčollu

utebli	heaibat

uteblivelse	healban

uteblivelsesdom	heaibanduopmu

utelate	guođđit

utelatelse	guođđin

utelufttilførsel	olgoáibmoboahtu

utelukkende	aivve

uten tilsyn	veaiddalas

utendørs støy	olgošlápma, olgoriedja

utenforstående	boaittos olmmoš

utenomsnakk	ášši olggobeal ságat

utenrettslig	dikkehis

utfall	boađus

utferdige	mearridit

utferdige et forelegg	mearridit sáhku

utferdigelse	mearrádus

utferdigelse av forelegg	sáhkkomearrádus

utferdiget	gárvvistuvvon

utflyttet	eretfárrejeaddji

utføre grimaser	nirvonárvohallat

utførelse	doaimmaheapmi
utførelse	čađaheapmi

utføring	čađaheapmi

utgrunne	coagan

utilfredsstillende	duđuheapmi

utilregnelig	vásttoheapme

utilrådelig	heivetmeahttun

utilsiktet	dáhpedorpmis

utilstrekkelig	vátni

utkikkspost	várdobáiki

utlegg	bággopánta

utleggsbegjæring	bearranozaheapmi

utleggsforretning	bearranmeannu

utleggspant	bearranpánta

utleggstrekk	bearrangeassin

utlevere	addit

utleveringsbegjæring	luohpanozaheapmi

utleveringsforretning	luohpanášši

utløpe	nohkat

utmarkskulturminner	meahccekulturmuittut

utmelding	geassádeapmi

utmeldingsregister	geassádanregisttar

utmåle	mihtidit

utmåling	merren
utmåling	mihtideapmi

utnyttingsgrad	geavahanmearri

utreiseforbud	riikaguođđingielddus

utsette for	čuohcat

utskiftbart	molssuhahtti

utskille	čuoldit

utskrift	čálus
utskrift	čáláhus

utskriftsområde	čálihanduovdda

utskriftsvennlig format	čálihanhápmi

utskrive forenklet forelegg	cealkit álkes sáhkkocelkosa

utskytingsrett	čuoldinvuoigatvuohta

utslagsvask	šávgalat

utstrakt rett	viiddis vuoigatvuohta

utstyres	bierggastuvvot

utstyrt	bierggastuvvon

utstå	maŋŋonit

uttaksregulering	bivdomudden

uttreden	mannan

utvidet	viiddiduvvon

utvikler	ovdánahtti

utviklingshemmet	ovddádusvádjit

uvedkommende	gulakeahttá

uvesentlig	mearkkašmeahttun

uvillig	vuostemielas

vaktstue	fáktalatnja

valdfordeling	vállajuohkin

vandel	eallingeardi

vandrefalk	bárbmofálli

vanlig tekst	buhtes teaksta

vannbehandling	čáhceráidnen

vannbehandlingsanlegg	čáhceráidnenrusttet

vannbyll	čáhcebuogu

vannbåren varme	čáhceliekkas

vannforsyningsanlegg	čáhcelágidanrusttet

vannhund	čáhcebeana

vanningsbil	čáhccenbiila

vannmagasin	čáhceálddis

vannpumpe	čáhcebumpe

vannsamling	čáhcečoahkku

vanuatuer	vanuatulaš

vareeier	gálvoeaiggát

varesykkel	duolbmanjorri

vareta	áimmahuššat

varetektsfange	háldofáŋga

varetektsfengsel	guhtaleapmi

varetektsfengsle	háldogiddagassii bidjat

varetektsfradrag	háldogiddagasgeasus

variabeluttrykk	molsašuddi cealkka

varmeavgivelse	liggen

varmebehandling	báhkkagieđahallan

varmegjennomgangsegenskap	liekkasrasttidaniešvuohta

varmegjennomgangskoeffisient	liekkasrasttidankoeffisieanta

varmeisolering	liekkaserren, liekkasguđjen

varmeproduserende	liekkasbuvttadeaddji

varmeproduserende enheter	liggenávnnasovttadagat

varmetapsramme	liekkassuođđanrámma

varmluftsanlegg	lieggaáibmoráhkkanus, lieggaáibmorusttet

varmluftspistol	báhkkaáibmoboson

varmtvannsproduksjon	lieggačáhcebuvttadeapmi

varp	váinniid muitoguhpa

varsler	skirri

varsling	dieđiheapmi

vaskemiddellager	basasrádju

vaskeplass	bassansadji

vaskesymbol	dikšunmearka

vater	čáhcečalbmi

vatikaner	vatikanstáhtalaš

vedkomme	gullat

vedlegge	mielddustit

vedlikeholder	máŧasdoalli

vedta en dom	dohkkehit duomu

vedta forelegg	dohkkehit sáhkkocelkosa

vedtakelse	dohkkeheapmi
vedtakelse	mearrideapmi

vedtaksfør	mearridanválddálaš

vedtekt	njuolggadus

vegdirektoratet	luoddadirektoráhtta

vegetasjonsfattig høyfjellsstrekning	čearru

vegetasjonsmerke	šaddodatmearka

veggrille	seaidnesadji

veianlegg	geaidnoráhkadus

veidefang	bivdin

veidestø	bivdosadji

veidetilpasning	bivdoheiveheapmi

veiledende	oaivadeaddji

veiledende årsplan	rávvejeaddji jahkeplána

vektig	dettolaš

vektor	vektor

velferdsmessig	čálggolaš

velferdstap	čálgomassin

venezuelaner	venezuelalaš

venstrepil	gurutnjuolla

verdiangivelse	árvoárvalus

verdier	árvvut

verdifastsetting	árvvošteapmi

verdiforringelse	árvoheajudeapmi

verdikonflikt	árvokonflikta

verdikretsløp	árvojohtu

verdimakismere	árvogierragahttit

verdimengde	árvodoahkki

verdiorientering	árvooaidnu

verdipapirhandellov	árvobábergávpeláhka

verdipapirregisterlov	árvobáberregisttarláhka

verdiskapende virksomhet	árvolasiheaddji doaibma

verdivurderingsstandard	árvoárvvoštallanmálle

verdsettelse	árvobidjan

verifiserbare	duođaštahtti

verneting	gustojeaddji diggi

versefot	diktajuolgi

versere	jorrat
versere	beaggit

vertikalplan	ceakkodássi

vertikalt kartotek	ceakkokartotehka

vesentlig kjennetegn	mearkkašahtti dovdomearka

videre behandling	joatkkameannudeapmi

vietnameser	vietnamlaš

viftereim	bosonruopma

viljeserklæring	dáhttocealkámuš

vilkår for straff	ráŋggáštaneaktu

villedende	doalvvuheaddji

vinkelprisme	čiehkaprisma

vinkelskrujern	čiehkaskruvvaruovdi

vinkelsliper	čiehkašliipa

vinkeltransportør	čiehkasirddan

vinterjogg	dálveskuovat

virkekrets	doaibmabiire

virkelig kostnad	duohtagollu

virkelig verdi	duohtaárvu

virkning som dom	váikkuhus duopmun

virtuell undervisning	virtuálaoahpahus

visningsbehandler	čájehangieđahalli, čájehandoalli

visningsmodus	čájehanmodus

viss mengde	dihtomearri

vitnebevis	vihtanduođaštus

vitneførsel	vihtanuššan

vitnegodtgjørelse	vihtanbálká

vitneplikt	vihtanuššangeatni

vitnesbyrd	vihtana čilgehus

vitnestevning	vihtanstevdnen

vitterlig	diehttalas

vognkort	registtargoarta

vognskjul	skearroskadja

volde	dagahit

volde skade	vahágahttit

voldgift	priváhta riidočoavdin

voldgiftsdommer	priváhtaduopmár

voldgiftsrett	priváhtariekti

voldsomhet	máđohisvuohta

voldsutøvelse	veahkaváldin

votere alternativt over	jienastit molssoeavttolaččat

vri figurer i tegneprogram	botnjat

vuopman	vuopman

våg	viehku

våke over	gozihit

væpnet	verjjolaš

være dyr	divrrastallat

være dyr på varen	divrrastaddat

være i knipe	boarskudit

væskebeholder	njalbelihtti

væsketap	goikan

wienerbrød	wienergáhkku

workshop	bargoseminára

xylitol	soahkesohkar, xylitola, ksylitola

yrkesbygning	fidnovisti

yteevne	bargonákca

ytre garnvegg av joddu	davveoalgi

ytre sirkeldefinisjon	olgguldas jorusmeroštallan

zambier	zambialaš

zimbabwer	zimbabwelaš

áiti	áiti

å bli støvet	dopmuluvvat

å få anfall	dohppehallat

å ha omsorg	ávvira atnit

åkerrein	niitoravda, giedderavda

åpenbare	iktit

åpne hovedforhandling	rahpat váldodiggoma

åpningsprosedyre	álggahanvuohki

årmann	áittardeaddji

åsted	rihkusbáiki
åsted	báiki

åstedsbefaring	báikegeahčadeapmi

åtetid	boggeáigi

ærbarhet	šiehku

ærekrenkelsessak	gudnerihkkunášši

ærekrenkende	gudnerihkolaš

æreskrenkelsessak	gudnerihkkunášši

ødemarkspreget	ávdinlágan

ødeåker	niitu

økonomisjef	ruhtadoallohoavda

øre-, nese-, halsavdeling	beallje-, njunne-, čottaossodat

ørebein	ágildákti

ørebeinstykke	ágilčaskkis

øreklokker	bealljegohput

østerriker	nuortariikalaš, lulliriikalaš

østtimoreser	lullitimorlaš, nuortatimorlaš

øverste båtbord	bordefiellu

øyenvitne	oidnovihtan

